[layer]
type=Tile Layer 1
data=
37,37,37,37,37,37,37,37,37,37,37,
37,37,1,37,37,37,37,37,1,37,37,
37,37,1,1,37,37,37,1,1,37,37,
37,37,1,1,1,1,1,1,1,37,37,
37,37,1,1,1,1,1,1,1,37,37,
37,37,1,1,38,1,38,1,1,37,37,
37,37,1,1,1,1,1,1,1,37,37,
37,37,1,38,38,38,38,38,1,37,37,
37,33,33,1,1,1,1,1,33,33,37,
37,33,33,33,33,33,33,33,33,33,37,
37,37,1,1,1,1,1,1,1,37,37,
37,37,1,33,33,33,33,33,1,37,37,
37,37,26,33,33,1,33,33,26,37,37,
0,0,0,0,0,0,0,0,0,0,0,
0,0,0,0,0,0,0,0,0,0,0,
0,0,0,0,0,0,0,0,0,0,0,
0,0,0,0,0,0,0,0,0,0,0.
[layer]
type=Tile Layer 2
data=
5,20,20,20,20,20,20,20,20,20,5,
5,20,80,20,20,20,20,20,80,20,5,
5,20,80,80,20,20,20,80,80,20,5,
5,20,80,80,80,80,80,80,80,20,5,
5,20,80,80,80,80,80,80,80,20,5,
5,20,80,80,1,80,1,80,80,20,5,
5,20,40,40,40,40,40,40,40,20,5,
5,20,40,1,1,1,1,1,40,20,5,
5,60,60,40,40,40,40,40,60,60,5,
5,60,60,60,60,60,60,60,60,60,5,
5,5,20,30,30,30,30,30,20,5,5,
5,5,20,10,10,10,10,10,20,5,5,
5,5,20,10,10,20,10,10,20,5,5,
0,0,0,0,0,0,0,0,0,0,0,
0,0,0,0,0,0,0,0,0,0,0,
0,0,0,0,0,0,0,0,0,0,0,
0,0,0,0,0,0,0,0,0,0,0.
