[layer]
type=Tile Layer 1
data=
0,0,0,32,0,33,0,0,0,0,0,
0,0,0,32,33,33,1,0,0,0,0,
0,33,33,33,33,1,1,1,0,0,0,
33,33,1,33,33,33,1,0,0,0,0,
33,33,33,36,33,33,1,1,0,0,0,
0,33,33,33,33,33,1,0,0,0,0,
0,0,0,0,33,1,1,1,0,0,0,
0,21,21,0,33,33,1,0,0,0,0,
0,21,21,0,32,33,1,1,0,0,0,
0,21,21,0,33,33,1,0,0,1,1,
0,21,21,0,32,33,1,1,33,1,0,
0,21,21,0,33,33,33,33,33,33,0,
0,21,21,0,33,32,33,33,32,33,0,
0,21,21,0,33,33,0,0,33,33,0,
0,0,0,0,0,0,0,0,0,0,0,
0,0,0,0,0,0,0,0,0,0,0,
0,0,0,0,0,0,0,0,0,0,0,
0,0,0,0,0,0,0,0,0,0,0.
[layer]
type=Tile Layer 2
data=
0,0,0,150,0,150,0,0,0,0,0,
0,0,0,150,150,150,120,0,0,0,0,
0,100,100,100,100,120,120,120,0,0,0,
80,80,80,80,80,80,120,0,0,0,0,
70,70,70,100,70,70,80,80,0,0,0,
0,60,60,60,60,60,80,0,0,0,0,
0,0,0,0,60,80,80,80,0,0,0,
0,0,0,0,50,50,80,0,0,0,0,
0,0,0,0,60,50,80,80,0,0,0,
0,0,0,0,50,50,80,0,0,80,80,
0,0,0,0,60,40,80,80,40,80,0,
0,0,0,0,40,40,40,40,40,40,0,
0,0,0,0,30,60,30,30,60,30,0,
0,0,0,0,30,30,0,0,30,30,0,
0,0,0,0,0,0,0,0,0,0,0,
0,0,0,0,0,0,0,0,0,0,0,
0,0,0,0,0,0,0,0,0,0,0,
0,0,0,0,0,0,0,0,0,0,0,
0,0,0,0,0,0,0,0,0,0,0.
