[layer]
type=Tile Layer 1
data=
0,0,0,33,33,33,33,33,0,0,0,
0,0,33,33,33,33,33,33,33,0,0,
0,33,17,17,33,17,17,33,33,33,0,
0,17,1,38,17,1,38,17,1,1,0,
0,17,38,38,17,38,38,17,1,1,0,
0,33,17,17,33,17,17,33,33,33,0,
0,33,33,33,33,33,33,33,33,33,0,
0,33,33,33,33,33,1,33,33,33,0,
21,33,33,1,1,1,33,33,33,33,21,
21,37,33,33,33,33,33,33,33,37,21,
21,33,37,37,37,37,37,37,37,33,21,
21,33,33,37,7,8,7,37,33,33,21,
21,33,33,37,7,24,7,37,33,33,21,
24,33,37,37,37,37,37,37,37,33,24,
1,1,37,37,37,37,37,37,37,1,1,
0,1,37,37,37,37,37,37,37,1,0,
0,0,0,1,1,0,1,1,0,0,0,
0,0,1,1,1,0,1,1,1,0,0,
0,0,0,0,0,0,0,0,0,0,0,
0,0,0,0,0,0,0,0,0,0,0,
0,0,0,0,0,0,0,0,0,0,0,
0,0,0,0,0,0,0,0,0,0,0,
0,0,0,0,0,0,0,0,0,0,0.
[layer]
type=Tile Layer 2
data=
0,0,0,150,150,150,150,150,0,0,0,
0,0,120,120,120,120,120,120,120,0,0,
0,100,40,40,100,40,40,100,100,100,0,
0,40,80,1,40,80,1,40,80,80,0,
0,40,1,1,40,1,1,40,80,80,0,
0,80,40,40,80,40,40,80,80,80,0,
0,80,80,80,80,80,80,80,80,80,0,
0,60,60,60,60,60,100,60,60,60,0,
0,60,60,100,100,100,60,60,60,60,0,
0,80,30,30,30,30,30,30,30,80,0,
0,70,40,40,40,40,40,40,40,70,0,
0,70,70,40,0,0,0,40,70,70,0,
0,70,70,40,0,0,0,40,70,70,0,
0,70,60,60,60,40,60,60,60,70,0,
10,10,60,60,60,40,60,60,60,10,10,
0,10,40,40,40,40,40,40,40,10,0,
0,0,0,10,10,0,10,10,0,0,0,
0,0,10,10,10,0,10,10,10,0,0,
0,0,0,0,0,0,0,0,0,0,0,
0,0,0,0,0,0,0,0,0,0,0,
0,0,0,0,0,0,0,0,0,0,0,
0,0,0,0,0,0,0,0,0,0,0,
0,0,0,0,0,0,0,0,0,0,0.
