[layer]
type=Tile Layer 1
data=
0,0,0,1,1,1,1,1,0,0,0,
0,0,1,1,1,1,1,1,1,0,0,
0,1,1,1,32,32,32,1,1,1,0,
0,1,1,32,1,1,1,32,1,1,0,
1,1,1,1,38,38,38,1,1,1,1,
1,1,1,38,38,38,38,38,1,1,1,
1,1,1,38,1,38,1,38,1,1,1,
1,1,1,38,1,38,1,38,1,1,1,
1,1,1,1,38,38,38,1,1,1,1,
24,1,1,37,1,1,1,37,1,1,24,
1,35,35,37,37,38,37,37,35,35,1,
1,38,38,1,37,37,37,1,38,38,1,
0,1,1,21,21,37,21,21,1,1,0,
0,0,1,21,21,21,21,21,1,0,0,
0,0,1,21,21,21,21,21,1,0,0,
0,0,1,21,21,21,21,21,1,0,0,
0,0,0,1,1,1,1,1,0,0,0,
0,0,0,0,0,0,0,0,0,0,0,
0,0,0,0,0,0,0,0,0,0,0,
0,0,0,0,0,0,0,0,0,0,0,
0,0,0,0,0,0,0,0,0,0,0.
[layer]
type=Tile Layer 2
data=
0,0,0,80,80,80,80,80,0,0,0,
0,0,80,80,80,80,80,80,80,0,0,
0,80,80,80,30,30,30,80,80,80,0,
0,60,60,30,60,60,60,30,60,60,0,
40,60,60,60,1,1,1,60,60,60,40,
40,60,60,1,1,1,1,1,60,60,40,
40,60,60,1,80,1,80,1,60,60,40,
40,60,60,1,80,1,80,1,60,60,40,
40,60,60,60,1,1,1,60,60,60,40,
0,50,50,50,50,50,50,50,50,50,0,
50,60,60,50,50,1,50,50,60,60,50,
50,1,1,50,50,50,50,50,1,1,50,
0,20,50,0,0,50,0,0,50,50,0,
0,0,50,0,0,0,0,0,50,0,0,
0,0,50,0,0,0,0,0,50,0,0,
0,0,50,0,0,0,0,0,50,0,0,
0,0,0,20,20,20,20,20,0,0,0,
0,0,0,0,0,0,0,0,0,0,0,
0,0,0,0,0,0,0,0,0,0,0,
0,0,0,0,0,0,0,0,0,0,0,
0,0,0,0,0,0,0,0,0,0,0.
