[layer]
type=Tile Layer 1
data=
0,0,0,32,32,32,32,32,0,0,0,
0,0,32,32,32,32,32,32,32,32,0,
0,0,37,37,37,33,37,33,0,0,0,
0,37,33,37,33,33,37,33,33,33,0,
0,37,33,37,37,33,33,37,33,33,33,
0,37,37,33,33,33,37,37,37,37,0,
0,0,0,33,33,33,33,33,33,0,0,
0,0,37,37,32,37,37,0,0,0,0,
24,37,37,37,32,37,32,37,37,37,24,
37,37,37,37,32,32,32,37,37,37,37,
33,33,37,32,33,32,33,32,37,33,33,
33,33,33,32,32,32,32,32,33,33,33,
33,33,32,32,32,32,32,32,32,33,33,
26,0,32,32,32,0,32,32,32,0,26,
0,37,37,37,0,0,0,37,37,37,0,
37,37,37,37,0,0,0,37,37,37,37,
0,0,0,0,0,0,0,0,0,0,0,
0,0,0,0,0,0,0,0,0,0,0,
0,0,0,0,0,0,0,0,0,0,0,
0,0,0,0,0,0,0,0,0,0,0,
0,0,0,0,0,0,0,0,0,0,0.
[layer]
type=Tile Layer 2
data=
0,0,0,120,120,120,120,120,0,0,0,
0,0,120,120,120,120,120,120,120,120,0,
0,0,100,100,100,150,100,50,0,0,0,
0,50,50,100,50,150,100,50,50,50,0,
0,50,50,100,100,150,20,100,50,200,200,
0,150,150,150,150,150,150,150,50,200,0,
0,0,0,50,50,50,50,50,50,0,0,
0,0,40,40,150,40,40,0,0,0,0,
0,15,40,40,70,40,30,40,40,15,0,
15,15,40,40,70,70,70,40,40,15,15,
15,40,40,40,100,70,100,40,40,40,15,
15,40,40,40,40,40,40,40,40,40,15,
15,20,30,30,30,30,30,30,30,20,15,
15,0,30,30,30,0,30,30,30,0,15,
0,15,15,15,0,0,0,15,15,15,0,
15,15,15,15,0,0,0,15,15,15,15,
0,0,0,0,0,0,0,0,0,0,0,
0,0,0,0,0,0,0,0,0,0,0,
0,0,0,0,0,0,0,0,0,0,0,
0,0,0,0,0,0,0,0,0,0,0,
0,0,0,0,0,0,0,0,0,0,0.
