[layer]
type=Tile Layer 1
data=
0,0,0,0,0,0,0,0,34,34,0,
0,0,0,0,0,0,0,32,33,34,34,
0,0,0,0,0,0,32,32,32,33,34,
0,0,0,0,0,32,32,16,32,33,34,
0,0,0,0,32,32,32,32,32,33,34,
0,0,0,32,32,32,16,32,32,33,34,
0,0,32,32,32,16,32,32,33,34,34,
0,32,32,16,32,32,32,33,34,34,0,
34,33,32,32,32,32,33,34,34,0,0,
34,34,33,33,33,33,34,34,0,0,0,
0,34,34,34,34,34,34,0,0,0,0,
0,0,0,0,0,0,0,0,0,0,0,
0,0,0,0,0,0,0,0,0,0,0,
0,0,0,0,0,0,0,0,0,0,0,
0,0,0,0,0,0,0,0,0,0,0,
0,0,0,0,0,0,0,0,0,0,0.
[layer]
type=Tile Layer 2
data=
0,0,0,0,0,0,0,0,5,5,0,
0,0,0,0,0,0,0,20,10,5,5,
0,0,0,0,0,0,20,20,20,10,5,
0,0,0,0,0,20,20,10,20,10,5,
0,0,0,0,20,20,20,20,20,10,5,
0,0,0,20,20,20,10,20,20,10,5,
0,0,20,20,20,10,20,20,10,5,5,
0,20,20,10,20,20,20,10,5,5,0,
5,10,20,20,20,20,10,5,5,0,0,
5,5,10,10,10,10,5,5,0,0,0,
0,5,5,5,5,5,5,0,0,0,0,
0,0,0,0,0,0,0,0,0,0,0,
0,0,0,0,0,0,0,0,0,0,0,
0,0,0,0,0,0,0,0,0,0,0,
0,0,0,0,0,0,0,0,0,0,0,
0,0,0,0,0,0,0,0,0,0,0.
