[layer]
type=Tile Layer 1
data=
0,0,0,37,37,37,37,37,0,0,0,
0,0,37,37,37,37,37,37,37,0,0,
0,37,37,37,37,37,37,37,37,37,0,
37,37,37,1,37,37,37,1,37,37,37,
37,37,1,38,1,33,1,38,1,37,37,
33,1,38,38,1,33,1,38,38,1,33,
33,1,38,1,33,33,33,1,38,1,33,
33,33,1,33,33,33,33,33,1,33,33,
33,33,33,33,33,9,33,33,33,33,33,
33,33,33,33,1,32,1,33,33,33,33,
32,32,33,33,1,32,1,33,33,32,32,
32,21,32,33,1,32,1,33,32,21,32,
32,32,21,32,21,1,21,32,21,32,32,
0,32,32,21,21,24,21,21,32,32,0,
0,0,32,21,32,32,32,21,32,0,0,
0,0,32,32,32,0,32,32,32,0,0,
0,0,0,0,0,0,0,0,0,0,0,
0,0,0,0,0,0,0,0,0,0,0,
0,0,0,0,0,0,0,0,0,0,0,
0,0,0,0,0,0,0,0,0,0,0.
[layer]
type=Tile Layer 2
data=
0,0,0,150,150,150,150,150,0,0,0,
0,0,120,150,150,150,150,120,120,0,0,
0,120,120,120,120,120,120,120,120,120,0,
20,100,100,100,100,100,100,100,100,100,20,
20,35,60,1,60,80,60,1,60,35,20,
10,60,1,1,60,80,60,1,1,60,10,
10,60,1,40,80,80,80,40,1,60,10,
10,30,40,80,80,80,80,80,40,30,10,
10,30,40,50,50,40,50,50,40,30,10,
10,30,40,50,40,80,40,50,40,30,10,
10,10,40,50,40,80,40,50,40,10,10,
10,20,10,20,40,80,40,20,10,20,10,
10,10,20,10,20,40,20,10,20,10,10,
0,10,10,20,20,20,20,20,10,10,0,
0,0,10,20,10,10,10,20,10,0,0,
0,0,10,10,10,0,10,10,10,0,0,
0,0,0,0,0,0,0,0,0,0,0,
0,0,0,0,0,0,0,0,0,0,0,
0,0,0,0,0,0,0,0,0,0,0,
0,0,0,0,0,0,0,0,0,0,0.
