[layer]
type=Tile Layer 1
data=
24,38,33,33,33,0,33,33,33,38,24,
38,38,32,33,33,33,33,33,32,38,38,
33,32,38,32,33,32,33,32,38,32,33,
33,33,32,38,32,32,32,38,32,33,33,
33,33,33,32,38,23,38,32,33,33,33,
0,33,32,32,23,26,23,32,32,33,0,
33,33,33,32,38,23,38,32,33,33,33,
33,33,32,38,32,32,32,38,32,33,33,
33,32,38,32,33,32,33,32,38,32,33,
38,38,32,33,33,33,33,33,32,38,38,
24,38,0,33,33,0,33,33,0,38,24,
0,0,0,0,0,0,0,0,0,0,0,
0,0,0,0,0,0,0,0,0,0,0,
0,0,0,0,0,0,0,0,0,0,0,
0,0,0,0,0,0,0,0,0,0,0.
[layer]
type=Tile Layer 2
data=
0,1,70,70,70,0,70,70,70,1,0,
1,1,90,70,70,70,70,70,90,1,1,
40,40,1,90,70,90,70,90,1,40,40,
40,40,40,1,90,90,90,1,40,40,40,
40,40,40,40,1,0,1,40,40,40,40,
0,20,40,40,0,20,0,40,40,20,0,
20,20,20,40,1,0,1,40,20,20,20,
20,20,40,1,20,20,20,1,40,20,20,
20,40,1,20,20,20,20,20,1,40,20,
1,1,20,20,20,20,20,20,20,1,1,
0,1,0,20,20,0,20,20,0,1,0,
0,0,0,0,0,0,0,0,0,0,0,
0,0,0,0,0,0,0,0,0,0,0,
0,0,0,0,0,0,0,0,0,0,0,
0,0,0,0,0,0,0,0,0,0,0.
