[layer]
type=Tile Layer 1
data=
0,0,0,0,0,1,0,0,0,0,0,
0,0,0,0,1,34,1,0,0,0,0,
0,0,0,1,34,34,36,1,0,0,0,
0,0,1,34,32,34,34,34,1,0,0,
7,1,33,34,34,34,34,37,34,1,7,
1,34,34,34,34,38,34,34,34,34,1,
1,37,34,1,1,1,1,1,34,34,1,
0,1,1,33,1,33,1,33,1,1,0,
0,0,1,33,1,33,1,33,1,0,0,
0,0,1,33,33,33,33,33,1,0,0,
0,0,0,1,1,1,1,1,0,0,0,
48,41,48,41,48,41,48,41,24,48,41,
0,0,0,0,0,0,0,0,0,0,0,
0,0,0,0,0,0,0,0,0,0,0,
0,0,0,0,0,0,0,0,0,0,0,
0,0,0,0,0,0,0,0,0,0,0.
[layer]
type=Tile Layer 2
data=
0,0,0,0,0,120,0,0,0,0,0,
0,0,0,0,120,120,120,0,0,0,0,
0,0,0,120,120,120,120,120,0,0,0,
0,0,120,80,120,80,80,80,120,0,0,
0,50,120,80,80,80,80,120,80,50,0,
50,60,60,60,60,1,60,60,60,60,50,
50,60,60,50,50,50,50,50,60,60,50,
0,50,50,30,50,30,50,30,50,50,0,
0,0,50,30,50,30,50,30,50,0,0,
0,0,50,30,30,30,30,30,50,0,0,
0,0,0,40,40,40,40,40,0,0,0,
20,20,20,20,20,20,20,20,0,20,20,
0,0,0,0,0,0,0,0,0,0,0,
0,0,0,0,0,0,0,0,0,0,0,
0,0,0,0,0,0,0,0,0,0,0,
0,0,0,0,0,0,0,0,0,0,0.
