[layer]
type=Tile Layer 1
data=
0,0,36,43,0,50,43,50,43,0,0,
57,36,36,36,36,35,35,35,35,0,0,
0,57,36,36,35,35,35,35,35,35,0,
0,0,36,35,35,35,9,35,9,35,35,
0,36,35,35,35,35,35,35,35,35,35,
36,36,35,35,35,35,1,1,1,35,35,
0,36,35,35,35,35,35,35,35,35,35,
36,36,35,35,35,35,35,35,35,35,24,
0,36,35,35,35,35,35,35,35,35,0,
0,50,35,35,35,35,35,35,35,35,0,
50,36,35,35,35,35,35,31,0,0,0,
57,36,35,35,35,35,35,24,24,0,0,
0,57,35,35,35,35,35,0,0,0,0,
0,0,0,1,0,1,0,0,0,0,0,
0,0,26,26,0,26,26,0,0,0,0,
0,0,0,0,0,0,0,0,0,0,0,
0,0,0,0,0,0,0,0,0,0,0,
0,0,0,0,0,0,0,0,0,0,0,
0,0,0,0,0,0,0,0,0,0,0,
0,0,0,0,0,0,0,0,0,0,0.
[layer]
type=Tile Layer 2
data=
0,0,140,140,0,140,140,140,100,0,0,
30,30,140,140,140,120,120,120,120,0,0,
0,30,80,80,90,90,90,90,90,90,0,
0,0,80,50,50,50,50,50,50,50,20,
0,60,80,80,80,80,80,80,80,80,20,
30,60,100,100,100,100,150,150,150,100,20,
0,60,60,60,40,60,60,60,60,60,20,
30,60,30,30,30,30,30,30,30,30,0,
0,60,60,60,60,60,60,60,60,60,0,
0,40,60,60,60,60,60,60,60,60,0,
30,40,60,60,60,60,60,0,0,0,0,
30,40,50,50,50,50,50,0,0,0,0,
0,40,80,80,80,80,80,0,0,0,0,
0,0,0,15,0,15,0,0,0,0,0,
0,0,15,15,0,15,15,0,0,0,0,
0,0,0,0,0,0,0,0,0,0,0,
0,0,0,0,0,0,0,0,0,0,0,
0,0,0,0,0,0,0,0,0,0,0,
0,0,0,0,0,0,0,0,0,0,0,
0,0,0,0,0,0,0,0,0,0,0.
