[layer]
type=Tile Layer 1
data=
38,32,1,0,0,0,0,0,0,0,0,
1,38,32,1,0,0,0,0,0,0,0,
0,1,38,32,1,0,0,0,0,0,0,
0,0,1,24,1,0,0,0,0,0,0,
0,0,1,32,1,1,1,0,0,0,0,
0,0,1,1,34,34,34,1,1,0,0,
0,1,34,34,34,34,34,34,34,1,0,
1,1,1,1,1,1,1,1,1,1,1,
1,34,34,34,34,34,34,34,34,34,1,
1,1,1,1,1,1,1,1,1,1,1,
0,1,32,32,32,32,32,32,32,1,0,
0,1,32,32,29,38,29,32,32,1,0,
0,1,32,32,32,38,32,32,32,1,0,
0,0,1,32,32,38,32,32,1,0,0,
0,0,1,32,38,38,38,32,1,0,0,
0,0,1,32,32,32,32,32,1,0,0,
0,0,0,1,32,32,32,1,0,0,0,
0,0,0,1,32,32,32,1,0,0,0,
0,0,0,1,1,1,1,1,0,0,0,
0,0,0,0,0,0,0,0,0,0,0,
0,0,0,0,0,0,0,0,0,0,0,
0,0,0,0,0,0,0,0,0,0,0,
0,0,0,0,0,0,0,0,0,0,0.
[layer]
type=Tile Layer 2
data=
1,140,140,0,0,0,0,0,0,0,0,
140,1,140,140,0,0,0,0,0,0,0,
0,140,1,140,140,0,0,0,0,0,0,
0,0,140,0,140,0,0,0,0,0,0,
0,0,150,150,150,150,150,0,0,0,0,
0,0,120,120,100,100,100,120,120,0,0,
0,90,90,90,90,90,90,90,90,90,0,
20,80,80,80,80,80,80,80,80,80,20,
20,40,40,40,40,40,40,40,40,40,20,
20,40,40,40,40,40,40,40,40,40,20,
0,40,80,120,120,120,120,120,80,40,0,
0,40,80,80,20,1,20,80,80,40,0,
0,40,40,80,80,1,80,80,40,40,0,
0,0,40,40,80,1,80,40,40,0,0,
0,0,20,40,1,1,1,40,20,0,0,
0,0,20,40,80,80,80,40,20,0,0,
0,0,0,20,40,80,40,20,0,0,0,
0,0,0,20,40,40,40,20,0,0,0,
0,0,0,30,30,30,30,30,0,0,0,
0,0,0,0,0,0,0,0,0,0,0,
0,0,0,0,0,0,0,0,0,0,0,
0,0,0,0,0,0,0,0,0,0,0,
0,0,0,0,0,0,0,0,0,0,0.
