[layer]
type=Tile Layer 1
data=
0,0,0,1,0,0,0,1,0,0,0,
0,0,1,1,0,0,0,1,1,0,0,
0,1,1,1,1,0,1,1,1,1,0,
0,0,0,1,1,0,1,1,0,0,0,
0,33,33,0,1,0,1,0,33,33,0,
33,0,0,33,1,1,1,33,0,0,33,
0,33,33,0,33,33,33,0,33,33,0,
21,0,0,33,33,33,33,33,0,0,21,
21,0,0,33,16,33,16,33,0,0,21,
0,33,33,33,33,33,33,33,33,33,0,
0,36,36,36,16,16,16,36,36,36,0,
0,36,36,36,33,16,33,36,36,36,0,
23,0,33,16,33,16,33,16,33,0,23,
23,22,0,33,16,16,16,33,0,22,23,
50,43,23,0,33,33,33,0,23,50,43,
0,0,0,0,0,0,0,0,0,0,0,
0,0,0,0,0,0,0,0,0,0,0,
0,0,0,0,0,0,0,0,0,0,0,
0,0,0,0,0,0,0,0,0,0,0.
[layer]
type=Tile Layer 2
data=
0,0,0,120,0,0,0,120,0,0,0,
0,0,120,120,0,0,0,120,120,0,0,
0,120,120,120,120,0,120,120,120,120,0,
0,0,0,120,120,0,120,120,0,0,0,
0,120,120,0,120,0,120,0,120,120,0,
40,0,0,120,120,120,120,120,0,0,40,
0,120,120,0,120,120,120,0,120,120,0,
0,0,0,50,50,50,50,50,0,0,0,
0,0,0,50,20,50,20,50,0,0,0,
0,50,50,50,50,50,50,50,50,50,0,
0,20,60,60,20,20,20,60,60,20,0,
0,20,60,60,50,20,50,60,60,20,0,
0,0,20,20,50,20,50,20,20,0,0,
0,0,0,20,20,20,20,20,0,0,0,
40,40,0,0,20,20,20,0,0,40,40,
0,0,0,0,0,0,0,0,0,0,0,
0,0,0,0,0,0,0,0,0,0,0,
0,0,0,0,0,0,0,0,0,0,0,
0,0,0,0,0,0,0,0,0,0,0.
