[layer]
type=Tile Layer 1
data=
0,0,0,0,32,32,32,32,32,0,0,
0,0,0,32,32,32,32,32,0,0,0,
0,0,32,32,32,32,32,32,32,32,0,
0,0,32,32,32,32,37,38,1,0,0,
0,0,32,37,37,38,37,38,1,37,37,
0,0,0,37,37,38,37,37,38,38,37,
0,0,0,0,35,38,38,38,35,0,0,
0,0,37,37,37,35,38,38,38,38,0,
0,37,37,0,37,37,37,38,38,38,37,
0,37,37,0,32,32,32,32,0,37,37,
0,0,32,32,32,0,0,32,32,32,0,
0,0,32,32,32,0,0,32,32,32,0,
0,0,0,0,0,0,0,0,0,0,0,
0,0,0,0,0,0,0,0,0,0,0,
0,0,0,0,0,0,0,0,0,0,0,
0,0,0,0,0,0,0,0,0,0,0,
0,0,0,0,0,0,0,0,0,0,0.
[layer]
type=Tile Layer 2
data=
0,0,0,0,75,75,75,75,75,0,0,
0,0,0,75,75,75,75,75,0,0,0,
0,0,75,75,75,75,75,75,75,75,0,
0,0,75,75,75,75,55,1,100,0,0,
0,0,75,55,55,1,55,1,100,55,55,
0,0,0,55,55,1,55,55,1,1,55,
0,0,0,0,80,1,1,1,80,0,0,
0,0,55,55,55,80,1,1,1,1,0,
0,55,55,0,55,55,55,1,1,1,55,
0,55,55,0,50,50,50,50,0,55,55,
0,0,50,50,50,0,0,50,50,50,0,
0,0,50,50,50,0,0,50,50,50,0,
0,0,0,0,0,0,0,0,0,0,0,
0,0,0,0,0,0,0,0,0,0,0,
0,0,0,0,0,0,0,0,0,0,0,
0,0,0,0,0,0,0,0,0,0,0,
0,0,0,0,0,0,0,0,0,0,0,
0,0,0,0,0,0,0,0,0,0,0.
