[layer]
type=Tile Layer 1
data=
0,0,0,0,1,38,1,0,0,0,0,
0,0,0,0,0,38,0,0,0,0,0,
0,0,0,0,1,38,1,0,0,0,0,
0,0,0,0,0,1,0,0,0,0,0,
0,0,0,0,0,1,0,0,0,0,0,
0,0,33,33,33,1,33,33,33,0,0,
0,33,33,33,33,1,33,33,33,33,0,
0,33,33,33,33,1,33,33,33,33,0,
0,0,33,33,33,1,33,33,33,0,0,
0,0,33,33,33,38,33,33,33,0,0,
0,33,33,33,38,31,38,33,33,33,0,
0,33,33,1,33,38,33,33,33,33,0,
33,33,33,33,33,26,33,33,33,33,33,
33,33,33,33,1,1,1,33,33,33,33,
33,33,33,33,33,33,33,33,33,33,33,
33,33,33,33,33,33,33,33,33,33,33,
24,33,33,33,33,33,33,33,33,33,24,
40,24,0,33,33,33,33,33,0,24,47,
0,40,24,0,33,33,33,0,24,47,0,
0,0,0,0,0,0,0,0,0,0,0,
0,0,0,0,0,0,0,0,0,0,0,
0,0,0,0,0,0,0,0,0,0,0.
[layer]
type=Tile Layer 2
data=
0,0,0,0,140,1,140,0,0,0,0,
0,0,0,0,0,1,0,0,0,0,0,
0,0,0,0,140,1,140,0,0,0,0,
0,0,0,0,0,140,0,0,0,0,0,
0,0,0,0,0,140,0,0,0,0,0,
0,0,100,100,100,140,100,100,100,0,0,
0,100,100,100,100,140,100,100,100,100,0,
0,70,80,80,80,140,80,80,80,70,0,
0,0,30,30,30,140,70,70,70,0,0,
0,0,70,70,70,1,70,70,70,0,0,
0,70,70,70,1,0,1,70,70,70,0,
0,70,70,60,70,1,70,70,70,70,0,
30,70,70,70,70,30,70,70,70,70,30,
30,50,50,50,60,60,60,50,50,50,30,
30,50,50,50,50,50,50,50,50,50,30,
30,40,40,40,40,40,40,40,40,40,30,
0,30,30,30,30,30,30,30,30,30,0,
40,0,0,20,20,20,20,20,0,0,40,
0,40,0,0,20,20,20,0,0,40,0,
0,0,0,0,0,0,0,0,0,0,0,
0,0,0,0,0,0,0,0,0,0,0,
0,0,0,0,0,0,0,0,0,0,0.
