[layer]
type=Tile Layer 1
data=
0,0,32,32,32,32,32,32,32,0,0,
0,32,1,1,1,1,1,1,1,32,0,
0,32,1,38,38,38,38,38,1,32,0,
0,32,1,38,38,31,38,38,1,32,0,
0,32,1,36,38,38,38,36,1,32,0,
0,32,1,38,36,36,36,38,1,32,0,
0,32,1,1,1,1,1,1,1,32,0,
0,32,32,32,32,32,32,32,32,32,0,
0,32,32,32,32,32,32,32,32,32,0,
0,32,32,1,32,32,32,32,31,32,0,
0,32,1,29,1,32,31,32,32,32,0,
0,32,32,1,32,32,32,32,32,32,0,
0,32,32,32,32,32,32,32,32,32,0,
0,0,32,32,32,32,32,32,32,0,0,
0,0,0,0,0,0,0,0,0,0,0,
0,0,0,0,0,0,0,0,0,0,0,
0,0,0,0,0,0,0,0,0,0,0,
0,0,0,0,0,0,0,0,0,0,0.
[layer]
type=Tile Layer 2
data=
0,0,100,100,100,100,100,100,100,0,0,
0,100,80,80,80,60,80,80,80,100,0,
0,100,80,1,1,1,1,1,80,100,0,
0,100,80,1,1,0,1,1,80,100,0,
0,100,80,100,1,1,1,100,80,100,0,
0,100,80,1,100,100,100,1,80,100,0,
0,100,80,80,80,80,80,80,80,100,0,
0,60,60,60,60,60,60,60,60,60,0,
0,40,40,40,40,40,40,40,40,40,0,
0,20,20,90,20,20,20,20,0,20,0,
0,20,90,10,90,20,0,20,20,20,0,
0,20,20,90,20,20,20,20,20,10,0,
0,20,20,20,20,20,20,20,10,5,0,
0,0,20,20,20,20,20,20,20,0,0,
0,0,0,0,0,0,0,0,0,0,0,
0,0,0,0,0,0,0,0,0,0,0,
0,0,0,0,0,0,0,0,0,0,0,
0,0,0,0,0,0,0,0,0,0,0.
