[layer]
type=Tile Layer 1
data=
0,0,0,32,32,32,32,32,0,0,0,
0,0,32,38,38,38,38,38,32,0,0,
0,32,38,32,37,37,37,32,38,32,0,
32,38,32,37,37,38,37,37,32,38,32,
32,38,37,38,38,38,38,38,37,38,32,
32,38,37,37,38,38,38,37,37,38,32,
32,38,37,38,38,37,38,38,37,38,32,
32,38,32,38,37,37,37,38,32,38,32,
0,32,38,32,37,37,37,32,38,32,0,
0,0,32,38,38,38,38,38,32,0,0,
0,0,0,32,32,32,32,32,0,0,0,
0,0,0,0,0,0,0,0,0,0,0,
0,0,0,0,0,0,0,0,0,0,0,
0,0,0,0,0,0,0,0,0,0,0,
0,0,0,0,0,0,0,0,0,0,0,
0,0,0,0,0,0,0,0,0,0,0.
[layer]
type=Tile Layer 2
data=
0,0,0,20,20,20,20,20,0,0,0,
0,0,20,1,1,1,1,1,20,0,0,
0,20,1,20,60,60,60,20,1,20,0,
20,1,20,60,60,1,60,60,20,1,20,
20,1,60,1,1,1,1,1,60,1,20,
20,1,60,60,1,1,1,60,60,1,20,
20,1,60,1,1,60,1,1,60,1,20,
20,1,20,1,60,60,60,1,20,1,20,
0,20,1,20,60,60,60,20,1,20,0,
0,0,20,1,1,1,1,1,20,0,0,
0,0,0,20,20,20,20,20,0,0,0,
0,0,0,0,0,0,0,0,0,0,0,
0,0,0,0,0,0,0,0,0,0,0,
0,0,0,0,0,0,0,0,0,0,0,
0,0,0,0,0,0,0,0,0,0,0,
0,0,0,0,0,0,0,0,0,0,0,
0,0,0,0,0,0,0,0,0,0,0.