[layer]
type=Tile Layer 1
data=
37,37,37,37,37,37,37,37,37,37,37,
37,37,37,38,38,37,37,37,37,37,37,
37,37,38,38,38,38,37,37,38,38,37,
37,37,37,38,38,37,37,38,38,38,38,
37,37,37,37,37,37,37,37,38,38,37,
1,1,1,38,38,38,1,1,1,37,37,
1,1,38,38,38,38,38,1,1,37,37,
37,38,1,38,38,38,1,38,37,37,37,
37,38,38,38,1,38,38,38,37,37,37,
37,38,38,38,32,38,38,38,37,37,37,
37,37,36,36,36,36,36,37,37,37,37,
34,34,38,38,38,38,38,34,1,34,34,
34,34,38,38,38,38,38,34,1,34,34,
34,1,1,38,1,1,38,38,38,34,34,
0,0,0,0,0,0,0,0,0,0,0,
0,0,0,0,0,0,0,0,0,0,0,
0,0,0,0,0,0,0,0,0,0,0,
0,0,0,0,0,0,0,0,0,0,0.
[layer]
type=Tile Layer 2
data=
20,70,70,90,90,90,70,70,70,70,20,
20,70,90,1,1,90,90,90,90,90,20,
30,90,1,1,1,1,90,90,1,1,30,
30,50,90,1,1,90,90,1,1,1,1,
20,50,50,50,50,50,50,50,1,1,50,
60,60,60,1,1,1,60,60,60,50,50,
60,60,1,1,1,1,1,60,60,50,50,
50,1,60,1,1,1,60,1,50,50,50,
50,1,1,1,60,1,1,1,50,50,50,
50,1,1,1,50,1,1,1,50,50,50,
50,50,50,50,50,50,50,50,50,50,50,
30,50,1,1,1,1,1,50,40,30,30,
30,50,1,1,1,1,1,50,40,30,30,
30,40,40,1,40,40,1,1,1,30,30,
0,0,0,0,0,0,0,0,0,0,0,
0,0,0,0,0,0,0,0,0,0,0,
0,0,0,0,0,0,0,0,0,0,0,
0,0,0,0,0,0,0,0,0,0,0.
