[layer]
type=Tile Layer 1
data=
0,36,33,33,33,33,33,36,0,0,0,
36,33,33,1,1,1,33,33,36,0,0,
36,33,1,29,1,29,1,33,36,0,0,
0,33,1,1,1,1,1,33,0,0,1,
0,33,33,1,1,1,33,33,0,1,1,
0,33,1,36,36,36,1,33,0,0,1,
1,1,33,1,1,1,33,1,1,0,0,
0,33,33,35,1,35,33,33,0,0,0,
0,0,0,35,35,35,0,0,36,0,0,
0,24,0,35,35,35,0,0,36,36,0,
0,1,0,0,35,35,35,0,35,36,36,
1,1,1,0,0,35,35,35,35,0,0,
0,0,0,0,0,0,0,0,0,0,0,
0,0,0,0,0,0,0,0,0,0,0,
0,0,0,0,0,0,0,0,0,0,0,
0,0,0,0,0,0,0,0,0,0,0.
[layer]
type=Tile Layer 2
data=
0,30,40,40,40,40,40,30,0,0,0,
30,40,40,20,20,20,40,40,30,0,0,
30,40,20,20,20,20,20,40,30,0,0,
0,40,20,20,20,20,20,40,0,0,30,
0,40,40,20,20,20,40,40,0,30,30,
0,40,20,30,30,30,20,40,0,0,30,
20,20,40,20,20,20,40,20,20,0,0,
0,40,40,20,20,20,40,40,0,0,0,
0,0,0,20,20,20,0,0,30,0,0,
0,0,0,20,20,20,0,0,30,30,0,
0,30,0,0,20,20,20,0,20,30,30,
30,30,30,0,0,20,20,20,20,0,0,
0,0,0,0,0,0,0,0,0,0,0,
0,0,0,0,0,0,0,0,0,0,0,
0,0,0,0,0,0,0,0,0,0,0,
0,0,0,0,0,0,0,0,0,0,0.