[layer]
type=Tile Layer 1
data=
0,0,0,1,0,0,0,1,0,0,0,
0,0,1,33,1,0,1,33,1,0,0,
0,1,33,1,0,0,0,1,33,1,0,
0,1,33,1,1,1,1,1,33,1,0,
0,1,33,1,33,33,33,1,33,1,0,
0,0,1,33,33,33,33,33,1,0,0,
0,1,33,1,1,33,1,1,33,1,0,
0,1,33,38,38,1,38,38,33,1,0,
0,1,33,38,1,38,1,38,33,1,0,
0,1,38,38,1,38,1,38,38,1,0,
0,1,34,38,38,38,38,38,34,1,0,
1,34,34,34,1,26,1,34,34,34,1,
1,38,1,33,33,33,33,33,1,38,1,
1,38,1,35,33,35,33,35,1,38,1,
1,29,1,33,35,35,35,33,1,29,1,
1,34,1,35,35,1,35,35,1,34,1,
1,34,1,33,33,1,33,33,1,34,1,
1,34,1,33,33,1,33,33,1,34,1,
24,1,24,1,1,24,1,1,24,1,24,
0,0,0,0,0,0,0,0,0,0,0,
0,0,0,0,0,0,0,0,0,0,0,
0,0,0,0,0,0,0,0,0,0,0,
0,0,0,0,0,0,0,0,0,0,0.
[layer]
type=Tile Layer 2
data=
0,0,0,150,0,0,0,150,0,0,0,
0,0,150,100,150,0,150,100,150,0,0,
0,110,100,110,0,0,0,110,100,110,0,
0,110,100,110,110,110,110,110,100,110,0,
0,110,100,80,80,80,80,80,100,20,0,
0,0,80,80,80,80,80,80,80,0,0,
0,80,80,80,80,80,80,80,80,80,0,
0,80,80,1,1,80,1,1,80,80,0,
0,80,80,1,80,1,80,1,80,80,0,
0,20,1,1,80,1,80,1,1,20,0,
0,20,60,1,1,1,1,1,60,20,0,
20,60,60,60,40,20,40,60,60,60,20,
20,1,20,50,50,50,50,50,20,1,20,
20,1,20,60,40,60,40,60,20,1,20,
20,20,20,40,60,60,60,40,20,20,20,
20,40,20,60,60,20,60,60,20,40,20,
20,40,20,20,20,20,20,20,20,40,20,
20,40,20,20,20,20,20,20,20,40,20,
0,20,0,20,20,0,20,20,0,20,0,
0,0,0,0,0,0,0,0,0,0,0,
0,0,0,0,0,0,0,0,0,0,0,
0,0,0,0,0,0,0,0,0,0,0,
0,0,0,0,0,0,0,0,0,0,0.
