[layer]
type=Tile Layer 1
data=
0,0,0,1,1,1,1,1,0,0,0,
0,0,1,32,32,32,32,32,1,0,0,
0,1,32,32,32,32,32,32,32,1,0,
1,32,32,32,32,32,32,32,32,32,1,
1,32,32,32,1,1,1,32,32,32,1,
1,1,1,1,1,33,1,1,1,1,1,
1,38,38,38,1,1,1,38,38,38,1,
1,38,38,38,38,38,38,38,38,38,1,
0,1,38,38,38,38,38,38,38,1,0,
0,0,1,38,38,38,38,38,1,0,0,
0,0,0,1,1,28,1,1,0,0,0,
0,0,0,0,0,0,0,0,0,0,0,
0,0,0,0,0,0,0,0,0,0,0,
0,0,0,0,0,0,0,0,0,0,0,
0,0,0,0,0,0,0,0,0,0,0,
0,0,0,0,0,0,0,0,0,0,0.
[layer]
type=Tile Layer 2
data=
0,0,0,60,60,60,60,60,0,0,0,
0,0,60,30,30,30,30,30,60,0,0,
0,60,30,30,30,30,30,30,30,60,0,
40,30,30,30,30,30,30,30,30,30,40,
40,30,30,30,60,60,60,30,30,30,40,
40,60,60,60,60,60,60,60,60,60,40,
40,1,1,1,40,40,40,1,1,1,40,
40,1,1,1,1,1,1,1,1,1,40,
0,60,1,1,1,1,1,1,1,60,0,
0,0,60,1,1,1,1,1,60,0,0,
0,0,0,60,60,30,60,60,0,0,0,
0,0,0,0,0,0,0,0,0,0,0,
0,0,0,0,0,0,0,0,0,0,0,
0,0,0,0,0,0,0,0,0,0,0,
0,0,0,0,0,0,0,0,0,0,0,
0,0,0,0,0,0,0,0,0,0,0,
0,0,0,0,0,0,0,0,0,0,0.
