[layer]
type=Tile Layer 1
data=
0,0,1,1,0,0,0,1,1,0,0,
0,1,33,33,1,1,1,33,33,1,0,
0,1,33,33,33,33,33,33,33,1,0,
1,33,33,24,33,33,33,24,33,33,1,
1,33,33,33,33,24,33,33,33,33,1,
1,33,1,1,33,33,33,1,1,33,1,
1,33,33,33,1,33,1,33,33,33,1,
1,33,1,3,1,1,1,4,1,33,1,
0,1,33,33,33,33,33,33,33,1,0,
26,33,1,33,33,2,33,33,1,33,26,
1,33,1,6,4,1,3,5,1,33,1,
1,33,33,33,33,33,33,33,33,33,1,
1,33,33,5,3,1,4,6,33,33,1,
1,33,33,1,33,33,33,1,33,33,1,
0,1,1,0,1,1,1,0,1,1,0,
0,0,0,0,0,0,0,0,0,0,0,
0,0,0,0,0,0,0,0,0,0,0,
0,0,0,0,0,0,0,0,0,0,0,
0,0,0,0,0,0,0,0,0,0,0.
[layer]
type=Tile Layer 2
data=
0,0,120,120,0,0,0,120,120,0,0,
0,120,80,120,120,120,120,120,80,120,0,
0,20,80,20,80,80,80,20,80,20,0,
30,60,60,0,60,35,60,0,60,60,30,
30,60,60,60,60,0,60,60,60,60,30,
20,60,60,60,60,60,60,60,60,60,20,
10,40,40,40,40,40,40,40,40,40,10,
10,40,40,40,40,40,40,40,40,35,10,
0,20,35,35,35,35,35,35,35,20,0,
5,35,20,35,35,20,35,35,20,35,5,
5,35,20,20,20,20,20,20,20,35,5,
5,20,20,20,20,20,20,20,20,20,5,
5,20,20,20,20,20,20,20,20,20,5,
5,20,20,20,20,20,20,20,20,20,5,
0,20,20,0,20,20,20,0,20,20,0,
0,0,0,0,0,0,0,0,0,0,0,
0,0,0,0,0,0,0,0,0,0,0,
0,0,0,0,0,0,0,0,0,0,0,
0,0,0,0,0,0,0,0,0,0,0.
