[layer]
type=Tile Layer 1
data=
0,0,0,0,0,34,0,0,0,0,0,
0,0,0,0,34,34,34,0,0,0,0,
0,0,0,34,34,29,34,0,34,34,0,
0,0,0,34,34,34,34,0,34,34,0,
0,0,0,34,34,34,34,0,34,34,34,
0,0,0,29,34,34,34,0,34,34,34,
34,34,0,34,34,34,29,34,34,34,34,
29,34,0,34,29,34,34,34,34,34,0,
29,34,34,34,34,34,34,34,34,0,0,
34,34,34,29,34,34,34,0,0,0,0,
0,0,34,34,34,29,34,0,0,0,0,
0,0,0,34,34,34,34,0,0,0,0,
0,0,0,34,29,34,34,0,0,0,0,
0,0,0,0,0,0,0,0,0,0,0,
0,0,0,0,0,0,0,0,0,0,0,
0,0,0,0,0,0,0,0,0,0,0,
0,0,0,0,0,0,0,0,0,0,0,
0,0,0,0,0,0,0,0,0,0,0.
[layer]
type=Tile Layer 2
data=
0,0,0,0,0,120,0,0,0,0,0,
0,0,0,0,120,120,120,0,0,0,0,
0,0,0,180,180,50,180,0,150,150,0,
0,0,0,120,120,120,120,0,150,150,0,
0,0,0,80,80,80,80,0,80,80,80,
0,0,0,50,80,120,120,0,150,150,150,
150,150,0,150,150,150,50,30,100,100,100,
50,30,0,30,50,30,30,100,100,100,0,
50,60,60,60,60,60,60,30,60,0,0,
60,60,30,50,60,60,60,0,0,0,0,
0,0,30,50,50,50,50,0,0,0,0,
0,0,0,40,40,40,40,0,0,0,0,
0,0,0,30,50,30,30,0,0,0,0,
0,0,0,0,0,0,0,0,0,0,0,
0,0,0,0,0,0,0,0,0,0,0,
0,0,0,0,0,0,0,0,0,0,0,
0,0,0,0,0,0,0,0,0,0,0,
0,0,0,0,0,0,0,0,0,0,0.
