[layer]
type=Tile Layer 1
data=
0,0,32,32,32,32,32,32,32,32,0,
0,32,33,33,32,32,32,33,33,32,32,
0,33,33,33,32,32,32,33,33,33,32,
0,33,38,38,33,33,33,38,38,33,32,
0,33,33,33,33,33,33,33,33,33,32,
0,32,33,33,33,33,33,33,33,32,32,
0,32,33,33,1,1,1,33,33,32,32,
0,0,32,33,33,33,33,33,32,32,0,
0,0,0,0,29,29,29,0,0,0,0,
0,0,32,32,32,32,32,32,32,32,0,
0,33,0,32,37,37,37,32,32,0,33,
0,33,0,32,32,37,32,32,32,0,33,
24,0,0,32,32,32,32,32,32,0,0,
0,0,0,33,32,32,32,33,33,0,0,
0,0,0,0,32,0,0,32,32,0,0,
0,0,0,0,0,0,0,0,0,0,0,
0,0,0,37,26,37,0,37,26,37,0,
0,0,0,37,26,37,0,37,26,37,0,
0,0,0,0,37,37,0,37,26,37,0,
0,0,0,0,0,0,0,0,37,37,0,
0,0,0,0,0,0,0,0,0,0,0,
0,0,0,0,0,0,0,0,0,0,0,
0,0,0,0,0,0,0,0,0,0,0.
[layer]
type=Tile Layer 2
data=
0,0,120,120,120,120,120,120,120,120,0,
0,120,120,120,120,120,120,120,120,120,120,
0,80,80,80,80,80,80,80,80,80,90,
0,80,1,1,90,90,90,1,1,80,90,
0,80,80,80,80,50,50,80,80,80,80,
0,70,50,50,50,50,50,50,50,60,60,
0,70,50,50,50,50,50,50,50,60,60,
0,0,70,50,50,50,50,50,60,60,0,
0,0,0,0,40,40,40,0,0,0,0,
0,0,80,80,80,80,80,80,80,80,0,
0,20,0,80,90,90,90,80,80,0,20,
0,20,0,80,80,90,80,80,80,0,20,
0,0,0,30,40,40,40,40,40,0,0,
0,0,0,60,60,60,60,60,60,0,0,
0,0,0,0,60,0,0,60,60,0,0,
0,0,0,0,0,0,0,0,0,0,0,
0,0,0,1,5,1,0,1,5,1,0,
0,0,0,1,5,1,0,1,5,1,0,
0,0,0,0,1,1,0,1,5,1,0,
0,0,0,0,0,0,0,0,1,1,0,
0,0,0,0,0,0,0,0,0,0,0,
0,0,0,0,0,0,0,0,0,0,0,
0,0,0,0,0,0,0,0,0,0,0.
