[layer]
type=Tile Layer 1
data=
0,0,0,0,0,0,1,0,0,0,0,
0,0,0,0,1,1,1,0,0,0,0,
0,0,0,38,38,38,38,38,0,0,0,
0,0,33,38,1,1,38,33,33,0,0,
0,0,38,38,1,1,38,38,38,0,0,
0,0,37,32,38,38,38,38,33,0,0,
0,0,0,1,1,1,1,1,0,0,0,
0,0,38,38,38,38,38,38,33,0,0,
0,38,38,38,38,38,38,33,1,1,0,
0,33,33,33,38,38,38,33,1,38,0,
33,1,1,38,33,38,38,33,38,1,1,
38,1,1,38,33,38,38,38,33,33,33,
1,38,1,33,38,38,38,38,38,38,38,
38,33,33,33,38,38,38,38,38,38,38,
0,38,38,38,38,33,33,33,38,38,0,
0,0,38,38,33,1,1,1,33,0,0,
0,0,0,33,1,38,38,38,0,0,0,
0,0,0,0,0,0,0,0,0,0,0,
0,0,0,0,0,0,0,0,0,0,0,
0,0,0,0,0,0,0,0,0,0,0,
0,0,0,0,0,0,0,0,0,0,0,
0,0,0,0,0,0,0,0,0,0,0.
[layer]
type=Tile Layer 2
data=
0,0,0,0,0,0,200,0,0,0,0,
0,0,0,0,200,200,200,0,0,0,0,
0,0,0,1,1,1,1,1,0,0,0,
0,0,200,1,200,200,1,200,200,0,0,
0,0,1,1,200,200,1,1,1,0,0,
0,0,300,300,1,1,1,1,200,0,0,
0,0,0,150,150,150,150,150,0,0,0,
0,0,1,1,1,1,1,1,150,0,0,
0,1,1,1,1,1,1,100,100,100,0,
0,150,150,150,1,1,1,100,100,1,0,
150,60,60,1,100,1,1,100,1,100,100,
1,60,60,1,100,1,1,1,100,100,100,
60,1,60,60,1,1,1,1,1,1,1,
1,60,60,60,1,1,1,1,1,1,1,
0,1,1,1,1,40,40,40,1,1,0,
0,0,1,1,40,30,30,30,40,0,0,
0,0,0,40,30,1,1,1,0,0,0,
0,0,0,0,0,0,0,0,0,0,0,
0,0,0,0,0,0,0,0,0,0,0,
0,0,0,0,0,0,0,0,0,0,0,
0,0,0,0,0,0,0,0,0,0,0,
0,0,0,0,0,0,0,0,0,0,0.
