[layer]
type=Tile Layer 1
data=
0,0,3,0,0,0,0,0,4,0,0,
0,0,1,3,0,0,0,4,1,0,0,
0,0,0,1,3,0,4,1,0,0,0,
0,0,0,0,1,1,1,0,0,0,0,
0,47,33,33,33,33,33,33,33,40,0,
47,33,33,33,33,33,33,33,33,33,40,
33,38,38,35,35,36,32,37,33,33,33,
33,38,38,35,35,36,32,37,33,1,33,
33,38,38,35,35,36,32,37,33,33,33,
33,38,38,35,35,36,32,37,33,1,33,
33,38,38,35,35,36,32,37,33,33,33,
33,38,38,35,35,36,32,37,33,32,33,
54,33,33,33,33,33,33,33,33,33,61,
0,54,33,33,33,33,33,33,33,61,0,
0,0,0,0,0,0,0,0,0,0,0,
0,0,0,0,0,0,0,0,0,0,0,
0,0,0,0,0,0,0,0,0,0,0,
0,0,0,0,0,0,0,0,0,0,0.
[layer]
type=Tile Layer 2
data=
0,0,50,0,0,0,0,0,50,0,0,
0,0,50,50,0,0,0,50,50,0,0,
0,0,0,50,50,0,50,50,0,0,0,
0,0,0,0,50,50,50,0,0,0,0,
0,20,20,20,20,20,20,20,20,20,0,
20,20,20,20,20,20,20,20,20,20,20,
20,1,1,20,20,30,50,50,20,20,20,
20,1,1,20,20,30,50,50,20,60,20,
20,1,1,20,20,30,50,50,20,20,20,
20,1,1,20,20,30,50,50,20,60,20,
20,1,1,20,20,30,50,50,20,20,20,
20,1,1,20,20,30,50,50,20,60,20,
20,20,20,20,20,20,20,20,20,20,20,
0,20,20,20,20,20,20,20,20,20,0,
0,0,0,0,0,0,0,0,0,0,0,
0,0,0,0,0,0,0,0,0,0,0,
0,0,0,0,0,0,0,0,0,0,0,
0,0,0,0,0,0,0,0,0,0,0.
