[layer]
type=Tile Layer 1
data=
1,1,0,0,0,0,0,0,0,1,1,
1,1,1,1,21,21,21,1,1,1,1,
33,33,1,1,21,21,21,1,1,33,33,
33,33,33,1,1,1,1,1,33,33,33,
33,33,33,33,33,33,33,33,33,33,33,
1,33,33,33,33,33,33,33,33,33,1,
1,1,33,33,30,33,30,33,33,1,1,
1,1,33,32,33,33,33,32,33,1,1,
1,33,33,1,1,1,1,1,33,33,1,
1,33,33,37,38,38,38,37,33,33,1,
1,33,33,37,38,38,38,37,33,33,1,
1,33,1,38,38,38,38,38,1,33,1,
1,1,1,1,1,26,1,1,1,1,1,
0,1,33,33,33,33,33,33,33,1,0,
0,1,33,1,33,33,33,1,33,1,0,
0,0,1,33,33,33,33,33,1,0,0,
24,0,0,1,1,1,1,1,0,0,24,
0,0,0,0,0,0,0,0,0,0,0,
0,0,0,0,0,0,0,0,0,0,0,
0,0,0,0,0,0,0,0,0,0,0,
0,0,0,0,0,0,0,0,0,0,0,
0,0,0,0,0,0,0,0,0,0,0.
[layer]
type=Tile Layer 2
data=
150,150,0,0,0,0,0,0,0,150,150,
120,120,120,120,0,0,0,120,120,120,120,
100,100,100,100,0,0,0,100,100,100,100,
100,100,100,80,40,20,40,80,100,100,100,
80,80,80,80,80,40,80,80,80,80,80,
50,80,80,80,80,40,80,80,80,80,50,
50,50,60,60,40,40,40,60,60,50,50,
50,50,40,100,20,20,20,100,40,50,50,
30,20,20,20,20,20,20,20,20,20,30,
30,20,20,60,1,1,1,60,20,20,30,
30,20,20,60,1,1,1,60,20,20,30,
30,20,30,1,1,1,1,1,40,20,30,
30,30,30,50,50,20,50,50,30,30,30,
0,20,20,20,20,20,20,20,20,20,0,
0,20,20,20,20,20,20,20,20,20,0,
0,0,20,20,20,20,30,20,20,0,0,
0,0,0,20,20,20,20,20,0,0,0,
0,0,0,0,0,0,0,0,0,0,0,
0,0,0,0,0,0,0,0,0,0,0,
0,0,0,0,0,0,0,0,0,0,0,
0,0,0,0,0,0,0,0,0,0,0,
0,0,0,0,0,0,0,0,0,0,0,
0,0,0,0,0,0,0,0,0,0,0.
