[layer]
type=Tile Layer 1
data=
0,0,1,1,1,1,1,1,1,0,0,
0,1,32,33,38,34,37,36,35,1,0,
0,1,33,38,34,37,36,35,32,1,0,
0,1,38,34,1,1,1,32,33,1,0,
0,1,34,37,1,0,1,33,38,1,0,
0,0,1,1,0,0,1,38,34,1,0,
0,0,0,0,0,1,38,34,37,1,0,
0,0,0,0,1,38,34,37,1,0,0,
0,0,0,1,38,34,37,1,0,0,0,
0,0,0,1,34,37,1,0,0,0,0,
0,0,0,1,37,36,1,0,0,0,0,
0,0,0,0,1,1,0,0,0,0,0,
21,21,0,1,33,32,1,0,21,21,21,
21,21,0,1,32,33,1,0,21,21,21,
21,21,0,0,1,1,0,0,21,21,21,
0,0,0,0,0,0,0,0,0,0,0,
0,0,0,0,0,0,0,0,0,0,0,
0,0,0,0,0,0,0,0,0,0,0,
0,0,0,0,0,0,0,0,0,0,0.
[layer]
type=Tile Layer 2
data=
0,0,40,40,40,40,40,40,40,0,0,
0,40,100,100,1,100,100,100,100,40,0,
0,40,100,1,100,100,100,100,100,40,0,
0,40,1,100,40,40,40,100,100,40,0,
0,40,100,100,40,0,40,100,1,40,0,
0,0,40,40,0,0,40,1,100,40,0,
0,0,0,0,0,40,1,100,80,40,0,
0,0,0,0,40,1,100,80,40,0,0,
0,0,0,40,1,100,80,40,0,0,0,
0,0,0,40,100,100,40,0,0,0,0,
0,0,0,40,100,100,40,0,0,0,0,
0,0,0,0,40,40,0,0,0,0,0,
0,0,0,40,70,70,40,0,0,0,0,
0,0,0,40,70,70,40,0,0,0,0,
0,0,0,0,40,40,0,0,0,0,0,
0,0,0,0,0,0,0,0,0,0,0,
0,0,0,0,0,0,0,0,0,0,0,
0,0,0,0,0,0,0,0,0,0,0,
0,0,0,0,0,0,0,0,0,0,0.
