[layer]
type=Tile Layer 1
data=
0,47,33,33,33,33,33,33,33,40,0,
0,33,33,33,33,33,33,33,33,33,0,
0,0,32,23,32,23,32,23,32,0,0,
0,33,33,33,33,33,33,33,33,33,0,
0,0,34,24,34,31,34,24,34,0,0,
0,33,33,33,33,33,33,33,33,33,0,
0,0,32,23,32,24,32,23,32,0,0,
0,33,33,33,33,33,33,33,33,33,0,
0,54,33,33,33,33,33,33,33,61,0,
0,0,0,0,0,0,0,0,0,0,0,
0,0,0,0,0,0,0,0,0,0,0,
0,0,0,0,0,0,0,0,0,0,0,
0,0,0,0,0,0,0,0,0,0,0,
0,0,0,0,0,0,0,0,0,0,0.
[layer]
type=Tile Layer 2
data=
0,10,10,10,10,10,10,10,10,10,0,
0,10,10,10,10,10,10,10,10,10,0,
0,0,20,0,20,0,20,0,20,0,0,
0,10,10,10,10,10,10,10,10,10,0,
0,0,20,0,20,0,20,0,20,0,0,
0,10,10,10,10,10,10,10,10,10,0,
0,0,20,0,20,0,20,0,20,0,0,
0,10,10,10,10,10,10,10,10,10,0,
0,10,10,10,10,10,10,10,10,10,0,
0,0,0,0,0,0,0,0,0,0,0,
0,0,0,0,0,0,0,0,0,0,0,
0,0,0,0,0,0,0,0,0,0,0,
0,0,0,0,0,0,0,0,0,0,0,
0,0,0,0,0,0,0,0,0,0,0,
0,0,0,0,0,0,0,0,0,0,0.
