[layer]
type=Tile Layer 1
data=
0,0,0,32,32,0,32,32,0,0,0,
0,0,32,32,32,32,32,32,32,0,0,
0,32,32,32,32,32,32,32,32,32,0,
32,32,1,1,32,32,32,1,1,32,32,
32,1,32,32,29,32,29,32,32,1,32,
32,32,32,32,32,32,32,32,32,32,32,
32,32,32,32,32,32,32,32,32,32,32,
0,0,32,32,32,32,32,32,32,0,0,
0,0,0,32,32,32,32,32,0,0,0,
0,34,34,0,32,32,32,0,34,34,0,
34,34,34,34,0,32,0,34,34,34,34,
0,34,34,34,27,34,27,34,34,34,0,
0,0,34,34,34,34,34,34,34,0,0,
0,0,0,0,0,34,0,0,0,0,0,
0,0,0,0,0,34,0,0,0,0,0,
0,0,0,0,0,34,0,0,0,0,0,
0,0,0,0,0,34,0,0,0,0,0,
0,0,0,0,0,34,0,0,0,0,0,
0,0,0,0,0,0,0,0,0,0,0,
0,0,0,0,0,0,0,0,0,0,0,
0,0,0,0,0,0,0,0,0,0,0,
0,0,0,0,0,0,0,0,0,0,0.
[layer]
type=Tile Layer 2
data=
0,0,0,100,100,0,100,100,0,0,0,
0,0,100,100,100,100,100,100,100,0,0,
0,100,100,100,100,100,100,100,100,100,0,
30,40,50,50,100,100,100,50,50,40,30,
30,50,40,40,50,90,50,40,40,50,30,
20,30,30,40,40,80,40,40,30,30,20,
20,30,30,40,40,70,40,40,30,30,20,
0,0,30,30,40,60,40,30,30,0,0,
0,0,0,30,30,50,30,30,0,0,0,
0,20,20,0,30,30,30,0,20,20,0,
20,20,20,20,0,30,0,20,20,20,20,
0,20,20,20,20,20,20,20,20,20,0,
0,0,20,20,20,20,20,20,20,0,0,
0,0,0,0,0,20,0,0,0,0,0,
0,0,0,0,0,20,0,0,0,0,0,
0,0,0,0,0,20,0,0,0,0,0,
0,0,0,0,0,20,0,0,0,0,0,
0,0,0,0,0,20,0,0,0,0,0,
0,0,0,0,0,0,0,0,0,0,0,
0,0,0,0,0,0,0,0,0,0,0,
0,0,0,0,0,0,0,0,0,0,0,
0,0,0,0,0,0,0,0,0,0,0.
