[layer]
type=Tile Layer 1
data=
5,5,1,0,1,1,0,0,0,1,1,
0,1,21,1,5,0,0,0,0,0,1,
6,1,0,1,1,1,5,3,1,1,1,
3,1,1,6,1,1,0,21,0,0,0,
0,5,1,5,1,1,21,0,0,0,1,
1,0,0,1,1,6,3,0,0,21,1,
5,0,0,0,0,0,21,0,0,0,1,
4,0,0,0,0,0,0,21,0,0,1,
1,0,0,0,0,1,0,21,0,3,1,
0,0,0,0,0,0,0,0,0,0,0,
0,0,0,0,0,0,0,0,0,0,0,
0,0,0,0,0,0,0,0,0,0,0,
0,0,0,0,0,0,0,0,0,0,0.
[layer]
type=Tile Layer 2
data=
46,46,46,0,46,46,0,0,0,46,46,
0,46,0,46,46,0,0,0,0,0,46,
28,28,0,28,28,28,28,28,28,28,28,
40,40,40,40,40,40,0,0,0,0,0,
0,40,40,40,40,40,0,0,0,0,40,
39,0,0,39,39,39,39,0,0,0,39,
38,0,0,0,0,0,0,0,0,0,38,
37,0,0,0,0,0,0,0,0,0,37,
37,0,0,0,0,37,0,0,0,37,37,
0,0,0,0,0,0,0,0,0,0,0,
0,0,0,0,0,0,0,0,0,0,0,
0,0,0,0,0,0,0,0,0,0,0,
0,0,0,0,0,0,0,0,0,0,0.