[layer]
type=Tile Layer 1
data=
0,1,0,0,0,0,0,0,0,1,0,
1,38,1,0,0,0,0,0,1,38,1,
1,38,38,1,0,0,0,1,38,38,1,
1,38,1,1,1,1,1,1,1,38,1,
1,1,33,32,33,32,33,32,33,1,1,
1,33,33,32,33,32,33,32,33,33,1,
1,33,37,33,33,33,33,33,37,33,1,
1,1,37,33,38,38,38,33,37,1,1,
1,38,38,38,1,1,1,38,38,38,1,
0,1,38,38,38,38,38,38,38,1,0,
0,0,1,1,1,23,1,1,1,0,0,
0,0,0,0,0,0,0,0,0,0,0,
0,0,0,0,0,0,0,0,0,0,0,
0,0,0,0,0,0,0,0,0,0,0,
0,0,0,0,0,0,0,0,0,0,0,
0,0,0,0,0,0,0,0,0,0,0.
[layer]
type=Tile Layer 2
data=
0,80,0,0,0,0,0,0,0,80,0,
80,1,80,0,0,0,0,0,80,1,80,
80,1,1,80,0,0,0,80,1,1,80,
80,1,80,80,80,40,80,80,80,1,80,
10,10,40,100,40,100,40,100,40,10,10,
10,40,40,100,40,100,40,100,40,40,10,
10,40,40,20,20,20,20,20,40,40,10,
10,10,40,20,1,1,1,20,40,10,10,
10,1,1,1,10,10,10,1,1,1,10,
0,10,1,1,1,1,1,1,1,10,0,
0,0,5,5,5,0,5,5,5,0,0,
0,0,0,0,0,0,0,0,0,0,0,
0,0,0,0,0,0,0,0,0,0,0,
0,0,0,0,0,0,0,0,0,0,0,
0,0,0,0,0,0,0,0,0,0,0,
0,0,0,0,0,0,0,0,0,0,0,
0,0,0,0,0,0,0,0,0,0,0.
