[layer]
type=Tile Layer 1
data=
0,0,0,37,37,37,37,34,0,0,0,
0,0,37,37,37,37,34,34,34,0,0,
0,37,37,37,37,34,34,34,34,34,0,
37,37,37,37,37,37,34,34,37,37,37,
34,34,37,37,37,37,37,34,37,37,37,
34,34,34,37,37,37,37,37,37,37,37,
34,34,34,34,37,37,37,34,34,37,37,
37,34,34,34,34,37,37,34,34,37,37,
0,34,34,34,34,37,37,34,34,37,0,
0,0,37,37,37,37,38,37,37,0,0,
0,0,0,37,38,38,24,37,0,0,0,
0,0,0,0,0,0,0,0,0,0,0,
0,0,0,0,0,0,0,0,0,0,0,
0,0,0,0,0,0,0,0,0,0,0,
0,0,0,0,0,0,0,0,0,0,0.
[layer]
type=Tile Layer 2
data=
0,0,0,10,10,10,10,40,0,0,0,
0,0,10,10,10,10,40,40,40,0,0,
0,10,10,10,10,40,40,40,40,40,0,
10,10,10,10,10,10,40,40,10,10,10,
40,40,5,5,5,5,5,40,5,5,5,
40,40,40,5,5,5,5,5,5,5,5,
40,40,40,40,5,5,5,40,40,5,5,
5,40,40,40,40,5,5,40,40,5,5,
0,40,40,40,40,5,5,40,40,5,0,
0,0,5,5,5,5,1,5,5,0,0,
0,0,0,5,1,1,1,5,0,0,0,
0,0,0,0,0,0,0,0,0,0,0,
0,0,0,0,0,0,0,0,0,0,0,
0,0,0,0,0,0,0,0,0,0,0,
0,0,0,0,0,0,0,0,0,0,0,
0,0,0,0,0,0,0,0,0,0,0.
