[layer]
type=Tile Layer 1
data=
0,0,0,32,32,32,32,32,0,0,0,
0,0,32,32,38,38,38,32,32,0,0,
0,0,32,32,32,32,32,32,32,0,0,
0,0,33,38,1,38,1,38,33,0,0,
0,0,38,38,33,33,33,38,38,0,0,
0,0,0,38,38,38,38,38,0,0,0,
0,38,32,37,32,32,32,37,32,38,0,
0,38,32,38,37,37,37,38,32,38,0,
0,0,0,37,37,37,37,37,0,0,0,
0,0,0,37,37,37,37,37,0,0,0,
24,0,0,33,33,0,33,33,0,0,24,
0,0,0,0,0,0,0,0,0,0,0,
0,0,0,0,0,0,0,0,0,0,0,
0,0,0,0,0,0,0,0,0,0,0,
0,0,0,0,0,0,0,0,0,0,0,
0,0,0,0,0,0,0,0,0,0,0.
[layer]
type=Tile Layer 2
data=
0,0,0,100,100,100,100,100,0,0,0,
0,0,100,100,1,1,1,100,100,0,0,
0,0,60,60,60,60,60,60,60,0,0,
0,0,70,1,60,1,60,1,70,0,0,
0,0,1,1,70,70,70,1,1,0,0,
0,0,0,1,1,1,1,1,0,0,0,
0,1,60,0,60,60,60,0,60,1,0,
0,1,60,1,20,20,20,1,60,1,0,
0,0,0,20,20,20,20,20,0,0,0,
0,0,0,20,20,20,20,20,0,0,0,
0,0,0,10,10,0,10,10,0,0,0,
0,0,0,0,0,0,0,0,0,0,0,
0,0,0,0,0,0,0,0,0,0,0,
0,0,0,0,0,0,0,0,0,0,0,
0,0,0,0,0,0,0,0,0,0,0,
0,0,0,0,0,0,0,0,0,0,0,
0,0,0,0,0,0,0,0,0,0,0.
