[layer]
type=Tile Layer 1
data=
1,1,1,1,1,0,1,1,1,1,1,
1,0,24,0,1,0,1,0,24,0,1,
0,38,24,38,0,0,0,38,24,38,0,
32,38,38,38,32,0,32,38,38,38,32,
32,38,38,38,32,0,32,38,38,38,32,
32,38,38,38,32,0,32,38,38,38,32,
32,38,38,38,32,12,32,38,38,38,32,
12,12,26,12,12,31,12,12,26,12,12,
0,0,0,0,0,0,0,0,0,0,0,
0,0,0,0,0,0,0,0,0,0,0,
0,0,0,0,0,0,0,0,0,0,0.
[layer]
type=Tile Layer 2
data=
50,50,50,50,50,0,50,50,50,50,50,
50,0,0,0,50,0,50,0,0,0,50,
0,1,0,1,0,0,0,1,0,1,0,
30,1,1,1,30,0,30,1,1,1,30,
30,1,1,1,30,0,30,1,1,1,30,
30,1,1,1,30,0,30,1,1,1,30,
30,1,1,1,30,5,30,1,1,1,30,
5,5,5,5,5,0,5,5,5,5,5,
0,0,0,0,0,0,0,0,0,0,0,
0,0,0,0,0,0,0,0,0,0,0,
0,0,0,0,0,0,0,0,0,0,0.
