[layer]
type=Tile Layer 1
data=
0,0,0,0,0,1,1,0,0,0,0,
0,0,0,0,0,29,0,0,0,0,0,
0,0,1,29,1,34,1,29,1,0,0,
0,1,34,34,34,34,34,34,34,1,0,
1,32,32,34,34,34,34,34,32,32,1,
1,32,1,38,32,34,32,32,1,32,1,
1,1,32,32,32,29,32,1,32,1,1,
0,1,32,32,32,32,32,32,32,1,0,
0,1,1,1,32,32,32,32,1,1,0,
0,0,1,32,32,29,32,32,1,0,0,
0,0,1,1,32,32,1,1,1,0,0,
0,0,0,1,32,32,32,1,0,0,0,
0,0,0,0,1,1,1,0,0,0,0,
0,0,0,0,0,0,0,0,0,0,0,
0,0,0,0,0,0,0,0,0,0,0,
0,0,0,0,0,0,0,0,0,0,0,
0,0,0,0,0,0,0,0,0,0,0,
0,0,0,0,0,0,0,0,0,0,0.
[layer]
type=Tile Layer 2
data=
0,0,0,0,0,50,50,0,0,0,0,
0,0,0,0,0,50,0,0,0,0,0,
0,0,5,5,5,50,5,5,5,0,0,
0,5,50,50,50,50,50,50,50,5,0,
5,20,20,50,50,50,50,50,20,20,5,
5,20,5,1,20,50,20,20,50,20,5,
5,5,20,20,20,20,20,50,20,5,5,
0,5,20,20,20,20,20,20,20,5,0,
0,5,5,5,20,20,20,20,5,5,0,
0,0,5,20,20,20,20,20,5,0,0,
0,0,5,5,20,20,5,5,5,0,0,
0,0,0,5,20,20,20,5,0,0,0,
0,0,0,0,5,5,5,0,0,0,0,
0,0,0,0,0,0,0,0,0,0,0,
0,0,0,0,0,0,0,0,0,0,0,
0,0,0,0,0,0,0,0,0,0,0,
0,0,0,0,0,0,0,0,0,0,0,
0,0,0,0,0,0,0,0,0,0,0,
0,0,0,0,0,0,0,0,0,0,0.
