[layer]
type=Tile Layer 1
data=
0,0,32,32,32,32,32,32,0,0,0,
0,32,33,32,32,32,33,32,32,0,0,
0,32,38,38,32,38,38,33,32,0,0,
0,32,33,33,33,33,33,33,32,0,0,
0,32,33,1,1,1,33,32,32,0,0,
0,0,32,33,33,33,32,32,0,0,0,
0,32,32,32,32,32,32,32,32,0,0,
23,32,32,37,37,37,32,32,33,32,24,
32,32,32,32,37,32,32,32,33,32,32,
32,32,0,32,32,32,32,0,32,32,32,
0,0,33,32,32,32,33,33,0,0,0,
0,0,32,32,32,0,32,32,32,0,0,
0,0,0,32,32,32,0,32,32,32,0,
0,0,0,0,32,32,1,0,32,32,1,
0,0,0,0,0,37,37,0,0,37,37,
0,0,0,0,0,0,0,0,0,0,0,
0,0,0,0,0,0,0,0,0,0,0,
0,0,0,0,0,0,0,0,0,0,0,
0,0,0,0,0,0,0,0,0,0,0,
0,0,0,0,0,0,0,0,0,0,0.
[layer]
type=Tile Layer 2
data=
0,0,60,60,60,60,60,60,0,0,0,
0,40,30,40,60,40,30,40,40,0,0,
0,40,1,1,60,1,1,30,40,0,0,
0,40,30,30,30,30,30,30,40,0,0,
0,40,30,60,60,60,30,40,40,0,0,
0,0,40,30,30,30,40,40,0,0,0,
0,40,40,40,40,40,40,40,40,0,0,
30,40,40,60,60,60,40,40,30,40,0,
20,40,40,40,60,40,40,40,30,40,20,
20,40,0,40,40,40,40,0,40,40,20,
0,0,30,40,40,40,30,30,0,0,0,
0,0,20,20,20,0,20,20,20,0,0,
0,0,0,20,10,10,0,20,10,10,0,
0,0,0,0,10,10,5,0,10,10,5,
0,0,0,0,0,5,5,0,0,5,5,
0,0,0,0,0,0,0,0,0,0,0,
0,0,0,0,0,0,0,0,0,0,0,
0,0,0,0,0,0,0,0,0,0,0,
0,0,0,0,0,0,0,0,0,0,0,
0,0,0,0,0,0,0,0,0,0,0.
