[layer]
type=Tile Layer 1
data=
0,0,0,1,1,0,1,1,0,0,0,
0,0,1,32,1,0,1,32,1,0,0,
0,1,32,32,1,0,1,32,32,1,0,
0,1,32,32,1,0,1,32,32,1,0,
0,1,32,32,1,0,1,32,32,1,0,
0,1,32,32,1,0,1,32,32,1,0,
0,1,32,37,1,0,1,37,32,1,0,
0,1,1,37,1,0,1,37,1,1,0,
0,0,0,1,24,1,24,1,0,0,0,
0,0,1,37,37,37,37,37,1,0,0,
0,1,37,37,37,37,37,37,37,1,0,
1,1,37,37,37,37,37,37,37,1,1,
1,37,37,1,37,37,37,1,37,37,1,
1,37,37,1,38,1,38,1,37,37,1,
1,37,38,38,38,38,38,38,38,37,1,
0,1,38,38,38,38,38,38,38,1,0,
0,0,1,1,24,24,24,1,1,0,0,
0,0,0,0,0,0,0,0,0,0,0,
0,0,0,0,0,0,0,0,0,0,0,
0,0,0,0,0,0,0,0,0,0,0,
0,0,0,0,0,0,0,0,0,0,0,
0,0,0,0,0,0,0,0,0,0,0.
[layer]
type=Tile Layer 2
data=
0,0,0,20,20,0,20,20,0,0,0,
0,0,20,40,20,0,20,40,20,0,0,
0,20,40,40,20,0,20,40,40,20,0,
0,20,40,40,20,0,20,40,40,20,0,
0,20,40,40,20,0,20,40,40,20,0,
0,20,40,40,20,0,20,40,40,20,0,
0,20,40,10,20,0,20,10,40,20,0,
0,20,20,10,20,0,20,10,20,20,0,
0,0,0,20,0,20,0,20,0,0,0,
0,0,20,20,20,20,20,20,20,0,0,
0,20,20,20,20,20,20,20,20,20,0,
20,20,15,15,15,15,15,15,15,20,20,
20,15,15,10,15,15,15,10,15,15,20,
20,15,15,10,1,10,1,10,15,15,20,
20,15,1,1,1,1,1,1,1,15,20,
0,20,1,1,1,1,1,1,1,20,0,
0,0,20,20,0,0,0,20,20,0,0,
0,0,0,0,0,0,0,0,0,0,0,
0,0,0,0,0,0,0,0,0,0,0,
0,0,0,0,0,0,0,0,0,0,0,
0,0,0,0,0,0,0,0,0,0,0,
0,0,0,0,0,0,0,0,0,0,0,
0,0,0,0,0,0,0,0,0,0,0.
