[layer]
type=Tile Layer 1
data=
0,0,32,32,32,32,32,32,32,0,0,
0,32,32,32,32,32,32,32,32,32,0,
32,32,32,1,32,32,32,1,32,32,32,
32,36,32,32,32,32,32,32,32,36,32,
32,32,33,33,33,33,33,33,33,32,32,
32,32,33,32,32,32,32,32,33,32,32,
32,32,33,33,33,33,33,33,33,32,32,
0,32,32,32,32,32,32,32,32,32,0,
0,0,32,32,32,32,32,32,32,0,0,
0,0,32,0,32,0,32,0,32,0,0,
26,32,32,0,32,0,32,0,32,32,26,
0,0,0,0,0,0,0,0,0,0,0,
0,0,0,0,0,0,0,0,0,0,0,
0,0,0,0,0,0,0,0,0,0,0,
0,0,0,0,0,0,0,0,0,0,0,
0,0,0,0,0,0,0,0,0,0,0.
[layer]
type=Tile Layer 2
data=
0,0,60,60,60,60,60,60,60,0,0,
0,60,60,60,60,60,60,60,60,60,0,
10,40,40,50,40,40,40,50,40,40,10,
10,50,20,20,40,40,40,20,20,50,10,
10,40,20,20,20,20,20,20,20,40,10,
10,40,20,40,40,40,40,40,20,40,10,
10,40,20,20,20,20,20,20,20,40,10,
0,20,40,40,40,20,40,40,40,20,0,
0,0,20,20,20,20,20,20,20,0,0,
0,0,10,0,10,0,10,0,10,0,0,
10,10,10,0,10,0,10,0,10,10,10,
0,0,0,0,0,0,0,0,0,0,0,
0,0,0,0,0,0,0,0,0,0,0,
0,0,0,0,0,0,0,0,0,0,0,
0,0,0,0,0,0,0,0,0,0,0,
0,0,0,0,0,0,0,0,0,0,0,
0,0,0,0,0,0,0,0,0,0,0.
