[layer]
type=Tile Layer 1
data=
0,8,1,1,1,25,1,1,1,8,0,
0,1,1,1,1,25,1,1,1,1,0,
0,1,1,1,1,1,1,1,1,1,0,
0,10,21,21,0,0,0,0,0,10,0,
0,10,21,12,12,12,12,12,12,10,0,
0,10,0,0,0,0,0,21,21,10,0,
0,10,12,12,12,12,12,12,21,10,0,
0,10,21,21,0,0,0,0,0,10,0,
0,10,12,12,12,12,12,12,12,10,0,
0,0,0,0,0,0,0,0,0,0,0,
0,0,0,0,0,0,0,0,0,0,0,
0,0,0,0,0,0,0,0,0,0,0,
0,0,0,0,0,0,0,0,0,0,0.
[layer]
type=Tile Layer 2
data=
0,0,40,40,40,0,40,40,40,0,0,
0,35,35,35,35,0,35,35,35,35,0,
0,30,20,20,20,20,20,20,20,30,0,
0,100,0,0,0,0,0,0,0,100,0,
0,100,0,70,70,70,70,70,70,100,0,
0,100,0,0,0,0,0,0,0,100,0,
0,100,70,70,70,70,70,70,0,100,0,
0,150,0,0,0,0,0,0,0,150,0,
0,200,3,60,60,60,60,60,60,150,0,
0,0,0,0,0,0,0,0,0,0,0,
0,0,0,0,0,0,0,0,0,0,0,
0,0,0,0,0,0,0,0,0,0,0,
0,0,0,0,0,0,0,0,0,0,0.
