[layer]
type=Tile Layer 1
data=
0,0,0,0,0,1,0,0,0,0,0,
0,0,0,0,1,25,1,0,0,0,0,
0,0,0,1,1,1,1,1,0,0,0,
0,0,1,21,1,1,1,21,1,0,0,
0,0,0,1,1,1,1,1,0,0,0,
0,0,1,21,1,1,1,21,1,0,0,
0,0,21,1,1,1,1,1,21,0,0,
0,2,2,2,2,2,2,2,2,2,0,
0,0,0,0,0,1,0,0,0,0,0,
0,0,0,0,0,1,0,0,0,0,0,
0,0,0,0,0,0,0,0,0,0,0.
[layer]
type=Tile Layer 2
data=
0,0,0,0,0,30,0,0,0,0,0,
0,0,0,0,30,0,30,0,0,0,0,
0,0,0,30,30,30,30,30,0,0,0,
0,0,25,0,25,25,25,0,25,0,0,
0,0,0,25,25,25,25,25,0,0,0,
0,0,20,0,20,20,20,0,20,0,0,
0,0,0,20,20,20,20,20,0,0,0,
0,10,10,10,10,10,10,10,10,10,0,
0,0,0,0,0,1,0,0,0,0,0,
0,0,0,0,0,1,0,0,0,0,0,
0,0,0,0,0,0,0,0,0,0,0.
