[layer]
type=Tile Layer 1
data=
0,1,25,1,0,1,0,1,7,1,0,
5,0,5,0,5,0,5,0,5,0,5,
0,3,0,3,7,3,0,3,0,3,0,
1,7,1,0,1,0,1,0,1,0,1,
0,5,0,5,0,5,0,5,7,5,0,
6,0,6,0,6,8,6,0,6,0,6,
21,1,0,1,0,1,0,1,25,1,0,
4,21,4,0,4,0,4,0,4,21,4,
0,5,21,5,0,1,8,5,0,5,21,
3,0,3,21,3,0,3,0,3,0,3,
0,1,0,1,0,1,0,1,0,1,21,
0,0,1,0,1,0,1,0,1,21,0,
0,0,0,0,0,0,0,0,0,0,0,
0,0,0,0,0,0,0,0,0,0,0,
0,0,0,0,0,0,0,0,0,0,0,
0,0,0,0,0,0,0,0,0,0,0.
[layer]
type=Tile Layer 2
data=
0,70,0,70,0,70,0,70,0,70,0,
40,0,40,0,30,0,30,0,40,0,40,
0,80,0,80,0,80,0,80,0,80,0,
45,0,45,0,45,0,45,0,45,0,45,
0,70,0,70,0,70,0,70,0,70,0,
50,0,50,0,50,0,50,0,50,0,50,
0,60,0,60,0,60,0,60,0,60,0,
50,0,50,0,50,0,50,0,50,0,50,
0,25,0,50,0,80,0,50,0,10,0,
40,0,40,0,40,0,40,0,40,0,10,
0,35,0,15,0,35,0,35,0,35,0,
0,0,35,0,10,0,30,0,30,0,0,
0,0,0,0,0,0,0,0,0,0,0,
0,0,0,0,0,0,0,0,0,0,0,
0,0,0,0,0,0,0,0,0,0,0,
0,0,0,0,0,0,0,0,0,0,0.
