[layer]
type=Tile Layer 1
data=
0,7,0,4,3,0,4,3,0,7,0,
7,0,0,1,1,25,1,1,0,0,0,
0,0,0,5,6,0,5,6,0,0,7,
0,8,0,0,0,0,0,0,0,8,0,
0,0,0,0,0,0,0,0,0,0,0,
6,4,1,3,0,0,0,4,1,3,5,
0,1,1,1,3,0,4,1,1,1,0,
0,1,1,1,1,1,1,1,1,1,0,
0,1,1,1,6,0,5,1,1,1,0,
3,5,1,6,0,0,0,5,1,6,4,
0,0,0,0,0,0,0,0,0,0,0,
0,0,0,0,0,0,0,0,0,0,0,
0,0,0,0,0,0,0,0,0,0,0,
0,0,0,0,0,0,0,0,0,0,0,
0,0,0,0,0,0,0,0,0,0,0.
[layer]
type=Tile Layer 2
data=
0,0,0,60,60,0,60,60,0,0,0,
0,0,0,35,40,0,40,35,0,0,0,
0,0,0,30,40,0,40,30,0,0,0,
0,0,0,0,0,0,0,0,0,0,0,
0,0,0,0,0,0,0,0,0,0,0,
5,20,15,10,0,0,0,10,15,20,5,
0,45,15,10,10,0,10,10,15,45,0,
0,45,15,15,20,50,20,15,15,45,0,
0,45,20,20,10,0,10,20,20,45,0,
5,10,15,10,0,0,0,10,15,10,5,
0,0,0,0,0,0,0,0,0,0,0,
0,0,0,0,0,0,0,0,0,0,0,
0,0,0,0,0,0,0,0,0,0,0,
0,0,0,0,0,0,0,0,0,0,0,
0,0,0,0,0,0,0,0,0,0,0.
