[layer]
type=Tile Layer 1
data=
0,1,0,1,0,1,0,1,0,1,0,
3,0,3,0,4,8,3,0,4,0,4,
1,7,5,0,1,1,1,0,6,7,1,
0,1,1,0,7,0,7,0,1,1,0,
7,0,0,1,0,25,0,1,0,0,7,
3,7,0,0,1,29,1,0,0,7,4,
21,3,0,0,0,1,0,0,0,4,21,
0,0,7,0,8,1,8,0,7,0,0,
0,24,1,7,1,0,1,7,1,24,0,
1,1,1,1,1,1,1,1,1,1,1,
0,0,0,0,0,0,0,0,0,0,0,
0,0,0,0,0,0,0,0,0,0,0,
0,0,0,0,0,0,0,0,0,0,0,
0,0,0,0,0,0,0,0,0,0,0,
0,0,0,0,0,0,0,0,0,0,0.
[layer]
type=Tile Layer 2
data=
0,30,0,30,0,30,0,30,0,30,0,
43,0,43,0,43,0,43,0,43,0,43,
90,0,90,0,90,90,90,0,90,0,90,
0,70,70,0,0,0,0,0,70,70,0,
0,0,0,36,0,0,0,36,0,0,0,
60,0,0,0,90,10,90,0,0,0,60,
0,60,0,0,0,90,0,0,0,60,0,
0,0,0,0,0,80,0,0,0,0,0,
0,0,60,29,60,0,60,29,60,0,0,
10,10,10,30,10,10,10,30,10,10,10,
0,0,0,0,0,0,0,0,0,0,0,
0,0,0,0,0,0,0,0,0,0,0,
0,0,0,0,0,0,0,0,0,0,0,
0,0,0,0,0,0,0,0,0,0,0,
0,0,0,0,0,0,0,0,0,0,0.
