[layer]
type=Tile Layer 1
data=
1,2,2,25,1,21,1,21,2,2,1,
2,0,0,0,1,1,1,0,0,21,2,
0,0,0,0,1,1,1,0,0,21,0,
21,13,13,13,25,1,25,13,13,13,0,
0,21,0,12,1,1,1,12,0,0,0,
0,2,2,2,0,0,0,2,2,2,21,
0,1,1,1,0,0,0,1,1,1,21,
0,13,13,13,0,25,0,13,13,13,0,
0,0,0,0,0,0,0,0,0,0,0,
0,0,0,0,0,0,0,0,0,0,0,
0,0,0,0,0,0,0,0,0,0,0.
[layer]
type=Tile Layer 2
data=
32,32,32,0,32,0,32,0,32,32,32,
35,0,0,0,35,35,35,0,0,0,35,
0,0,0,0,34,34,34,0,0,0,0,
0,33,33,33,0,33,0,33,33,33,0,
0,0,0,33,33,33,33,33,0,0,0,
0,32,32,32,0,0,0,32,32,32,0,
0,31,31,31,0,0,0,31,31,31,0,
0,31,31,31,0,0,0,31,31,31,0,
0,0,0,0,0,0,0,0,0,0,0,
0,0,0,0,0,0,0,0,0,0,0,
0,0,0,0,0,0,0,0,0,0,0.
