[layer]
type=Tile Layer 1
data=
0,1,1,0,1,1,1,0,1,1,0,
0,1,0,0,0,25,1,0,1,0,0,
0,16,16,7,1,1,1,0,16,16,0,
0,0,16,21,1,0,0,21,0,16,0,
0,16,16,21,17,17,17,21,16,16,0,
0,1,0,21,0,0,17,21,1,0,0,
0,1,1,0,17,17,17,7,1,1,0,
0,0,1,0,1,0,0,0,0,1,0,
0,17,17,0,1,1,1,0,17,17,0,
0,17,21,0,21,21,1,0,17,21,0,
0,17,17,7,16,16,16,0,17,17,0,
0,0,1,0,16,25,0,0,0,1,0,
0,1,1,0,16,16,16,7,1,1,0,
0,1,21,0,21,21,1,0,1,21,0,
0,1,1,0,1,1,1,0,1,1,0,
0,0,0,0,0,0,0,0,0,0,0,
0,0,0,0,0,0,0,0,0,0,0,
0,0,0,0,0,0,0,0,0,0,0,
0,0,0,0,0,0,0,0,0,0,0.
[layer]
type=Tile Layer 2
data=
0,80,80,0,80,80,80,0,80,80,0,
0,80,0,0,0,0,80,0,80,0,0,
0,50,50,0,80,80,80,0,50,50,0,
0,0,50,0,80,0,0,0,0,50,0,
0,50,50,0,50,50,50,0,50,50,0,
0,70,0,0,0,0,50,0,70,0,0,
0,70,70,0,50,50,50,0,70,70,0,
0,0,70,0,70,0,0,0,0,70,0,
0,50,50,0,60,60,60,0,50,50,0,
0,50,0,0,0,0,60,0,50,0,0,
0,50,50,0,50,50,50,0,50,50,0,
0,0,50,0,50,0,0,0,0,50,0,
0,50,50,0,50,50,50,0,50,50,0,
0,50,0,0,0,0,50,0,50,0,0,
0,50,50,0,50,50,50,0,50,50,0,
0,0,0,0,0,0,0,0,0,0,0,
0,0,0,0,0,0,0,0,0,0,0,
0,0,0,0,0,0,0,0,0,0,0,
0,0,0,0,0,0,0,0,0,0,0.
