[layer]
type=Tile Layer 1
data=
7,5,1,0,0,7,1,0,1,0,0,
7,3,5,1,0,7,1,25,1,1,1,
7,5,3,5,1,7,1,1,1,0,1,
7,0,5,3,5,7,1,1,1,1,1,
7,1,1,6,4,1,6,24,4,11,11,
7,1,6,4,1,6,21,4,20,1,1,
7,6,4,1,6,21,4,20,1,1,1,
7,3,5,6,21,4,20,1,1,1,1,
7,1,6,21,4,20,1,1,1,1,1,
20,6,21,4,20,20,20,20,20,20,20,
0,0,0,0,0,0,0,0,0,0,0,
0,0,0,0,0,0,0,0,0,0,0,
0,0,0,0,0,0,0,0,0,0,0,
0,0,0,0,0,0,0,0,0,0,0,
0,0,0,0,0,0,0,0,0,0,0.
[layer]
type=Tile Layer 2
data=
0,50,50,0,0,0,50,0,50,0,0,
0,50,50,50,0,0,50,0,50,50,50,
0,50,50,50,50,0,50,50,50,0,50,
0,0,50,50,50,0,50,50,50,50,50,
0,50,50,50,50,50,50,0,50,70,70,
0,50,50,50,50,50,0,50,0,30,50,
0,50,50,50,50,0,50,0,30,50,30,
0,50,50,50,0,50,0,30,50,30,50,
0,50,50,0,50,0,30,50,30,50,30,
0,50,0,50,0,0,0,0,0,0,0,
0,0,0,0,0,0,0,0,0,0,0,
0,0,0,0,0,0,0,0,0,0,0,
0,0,0,0,0,0,0,0,0,0,0,
0,0,0,0,0,0,0,0,0,0,0,
0,0,0,0,0,0,0,0,0,0,0.
