[layer]
type=Tile Layer 1
data=
0,0,0,8,0,0,0,8,0,0,0,
0,8,0,0,0,0,0,0,0,8,0,
0,1,1,1,1,1,1,1,1,1,0,
0,0,0,0,0,0,0,0,0,0,0,
17,17,17,17,17,1,16,16,16,16,16,
0,16,25,16,0,0,0,17,25,17,0,
0,16,0,16,0,0,0,17,0,17,0,
0,16,0,16,0,0,0,17,0,17,0,
0,16,0,16,0,0,0,17,0,17,0,
16,16,16,16,1,1,1,17,17,17,17,
0,0,0,0,0,0,0,0,0,0,0,
0,0,0,0,0,0,0,0,0,0,0,
0,0,0,0,0,0,0,0,0,0,0,
0,0,0,0,0,0,0,0,0,0,0.
[layer]
type=Tile Layer 2
data=
0,0,0,0,0,0,0,0,0,0,0,
0,0,0,0,0,0,0,0,0,0,0,
0,100,100,100,100,100,100,100,100,100,0,
0,0,0,0,0,0,0,0,0,0,0,
20,20,20,20,20,10,20,20,20,20,20,
0,35,0,35,0,0,0,35,0,35,0,
0,35,0,35,0,0,0,35,0,35,0,
0,35,0,35,0,0,0,35,0,35,0,
0,35,0,35,0,0,0,35,0,35,0,
10,30,10,30,10,30,10,30,10,30,10,
0,0,0,0,0,0,0,0,0,0,0,
0,0,0,0,0,0,0,0,0,0,0,
0,0,0,0,0,0,0,0,0,0,0,
0,0,0,0,0,0,0,0,0,0,0.
