[layer]
type=Tile Layer 1
data=
0,1,1,0,1,0,1,0,1,1,0,
1,21,21,1,1,1,1,1,21,21,1,
1,1,1,25,1,1,1,25,1,1,1,
0,1,1,1,1,1,1,1,1,1,0,
0,0,1,1,1,1,1,1,1,0,0,
0,1,1,1,21,1,21,1,1,1,0,
0,1,1,21,1,1,1,21,1,1,0,
0,0,1,1,0,24,0,1,1,0,0,
0,0,0,0,0,0,0,0,0,0,0,
0,0,0,0,0,0,0,0,0,0,0,
0,0,0,0,0,0,0,0,0,0,0.
[layer]
type=Tile Layer 2
data=
0,60,60,0,60,0,60,0,60,60,0,
60,0,0,60,40,60,40,60,0,0,60,
60,40,40,0,60,5,60,0,40,40,60,
0,60,40,40,60,5,60,40,40,60,0,
0,0,60,60,40,5,40,60,60,0,0,
0,60,40,40,0,5,0,40,40,60,0,
0,60,40,0,60,5,60,0,40,60,0,
0,0,60,60,0,5,0,60,60,0,0,
0,0,0,0,0,0,0,0,0,0,0,
0,0,0,0,0,0,0,0,0,0,0,
0,0,0,0,0,0,0,0,0,0,0.
