[layer]
type=Tile Layer 1
data=
1,1,1,1,1,24,1,1,1,1,1,
8,8,1,0,0,0,0,0,1,8,8,
8,4,1,3,25,0,25,4,1,3,8,
4,1,1,1,3,0,4,1,1,1,3,
1,1,1,1,1,7,1,1,1,1,1,
0,1,1,1,0,1,0,1,1,1,0,
0,1,1,1,0,1,0,1,1,1,0,
1,1,1,1,1,1,1,1,1,1,1,
6,8,1,8,1,0,1,8,1,8,5,
8,0,8,0,8,24,8,0,8,0,8,
0,20,20,20,20,0,20,20,20,20,0,
0,0,0,0,0,0,0,0,0,0,0,
0,0,0,0,0,0,0,0,0,0,0,
0,0,0,0,0,0,0,0,0,0,0.
[layer]
type=Tile Layer 2
data=
0,0,0,0,0,0,0,0,0,0,0,
0,0,0,0,0,0,0,0,0,0,0,
0,0,0,0,0,0,0,0,0,0,0,
0,0,0,0,0,0,0,0,0,0,0,
0,0,0,0,0,0,0,0,0,0,0,
0,0,0,0,0,0,0,0,0,0,0,
0,0,0,0,0,0,0,0,0,0,0,
0,0,0,0,0,0,0,0,0,0,0,
0,0,0,0,0,0,0,0,0,0,0,
0,0,0,0,0,0,0,0,0,0,0,
0,0,0,0,0,0,0,0,0,0,0,
0,0,0,0,0,0,0,0,0,0,0,
0,0,0,0,0,0,0,0,0,0,0,
0,0,0,0,0,0,0,0,0,0,0.
