[layer]
type=Tile Layer 1
data=
0,21,0,0,0,8,0,0,0,21,0,
0,0,1,0,0,1,0,0,1,0,0,
0,0,0,1,0,1,0,1,0,0,0,
0,0,0,0,1,1,1,0,0,0,0,
0,7,1,1,1,25,1,1,1,7,0,
0,0,0,0,1,1,1,0,0,0,0,
0,0,0,1,0,1,0,1,0,0,0,
0,0,1,0,0,1,0,0,1,0,0,
0,21,0,0,0,8,0,0,0,21,0,
0,0,0,0,0,0,0,0,0,0,0,
0,0,0,0,0,0,0,0,0,0,0.
[layer]
type=Tile Layer 2
data=
0,0,0,0,0,0,0,0,0,0,0,
0,0,10,0,0,30,0,0,10,0,0,
0,0,0,40,0,60,0,40,0,0,0,
0,0,0,0,80,90,80,0,0,0,0,
0,0,30,60,90,0,90,60,30,0,0,
0,0,0,0,80,90,80,0,0,0,0,
0,0,0,40,0,40,0,40,0,0,0,
0,0,10,0,0,10,0,0,10,0,0,
0,0,0,0,0,0,0,0,0,0,0,
0,0,0,0,0,0,0,0,0,0,0,
0,0,0,0,0,0,0,0,0,0,0.
