[layer]
type=Tile Layer 1
data=
0,0,25,0,0,0,0,0,25,0,0,
0,4,3,0,0,0,0,0,4,3,0,
0,10,6,0,0,0,0,0,5,10,0,
22,1,3,8,0,0,0,8,4,1,22,
3,8,10,3,0,0,0,4,10,8,4,
10,3,8,1,21,0,21,1,8,4,10,
0,10,3,1,0,0,0,1,4,10,0,
0,0,10,1,0,0,0,1,10,0,0,
0,0,0,10,3,25,4,10,0,0,0,
0,0,0,0,1,1,1,0,0,0,0,
0,0,0,0,0,1,0,0,0,0,0,
0,0,0,0,0,0,0,0,0,0,0,
0,0,0,0,0,0,0,0,0,0,0,
0,0,0,0,0,0,0,0,0,0,0,
0,0,0,0,0,0,0,0,0,0,0.
[layer]
type=Tile Layer 2
data=
0,0,0,0,0,0,0,0,0,0,0,
0,57,57,0,0,0,0,0,57,57,0,
0,30,57,0,0,0,0,0,57,30,0,
0,57,25,0,0,0,0,0,25,57,0,
50,0,100,75,0,0,0,75,100,0,50,
60,50,0,66,0,0,0,66,0,50,60,
0,60,50,66,0,0,0,66,50,60,0,
0,0,60,40,0,0,0,43,50,0,0,
0,0,0,60,40,0,40,50,0,0,0,
0,0,0,0,40,20,40,0,0,0,0,
0,0,0,0,0,20,0,0,0,0,0,
0,0,0,0,0,0,0,0,0,0,0,
0,0,0,0,0,0,0,0,0,0,0,
0,0,0,0,0,0,0,0,0,0,0,
0,0,0,0,0,0,0,0,0,0,0.
