[layer]
type=Tile Layer 1
data=
1,2,0,1,21,1,25,1,2,1,0,
21,1,8,0,0,1,0,0,0,1,0,
2,1,1,1,1,0,1,1,1,2,1,
0,0,25,0,0,1,1,1,0,0,21,
1,1,1,1,1,1,21,1,1,1,1,
21,1,1,2,0,1,0,2,1,1,1,
0,2,0,21,0,1,0,0,25,0,0,
21,1,0,1,1,1,1,1,1,1,1,
0,1,0,1,0,0,0,1,0,0,21,
1,1,21,1,0,1,0,1,0,1,1,
0,1,25,0,8,1,0,21,0,2,0,
24,1,1,2,21,2,1,1,1,1,0,
0,21,0,0,0,1,0,0,0,1,0,
1,1,1,1,1,1,0,1,21,1,1,
0,0,0,0,0,0,0,1,0,1,0,
1,1,1,1,1,1,1,0,1,1,1,
0,0,0,1,1,0,0,1,25,0,0,
1,1,0,1,1,1,21,1,1,1,1,
0,1,0,0,0,1,0,0,21,0,0,
0,0,0,0,0,0,0,0,0,0,0,
0,0,0,0,0,0,0,0,0,0,0,
0,0,0,0,0,0,0,0,0,0,0,
0,0,0,0,0,0,0,0,0,0,0.
[layer]
type=Tile Layer 2
data=
86,86,0,86,0,86,0,86,86,86,0,
0,127,0,0,0,127,0,0,0,127,0,
67,67,67,67,67,0,67,67,67,67,67,
0,0,0,0,0,91,91,91,0,0,0,
72,72,72,72,72,72,0,72,72,72,72,
0,89,89,89,0,89,0,89,89,89,89,
0,81,0,0,0,81,0,0,0,0,0,
0,72,0,72,72,72,72,72,72,72,72,
0,78,0,78,0,0,0,78,0,0,0,
71,71,0,71,0,71,0,71,0,71,71,
0,105,0,0,0,105,0,0,0,105,0,
0,103,103,103,0,103,103,103,103,103,0,
0,0,0,0,0,61,0,0,0,61,0,
54,54,54,54,54,54,0,54,0,54,54,
0,0,0,0,0,0,0,59,0,59,0,
48,48,48,48,48,48,48,0,48,48,48,
0,0,0,59,59,0,0,59,0,0,0,
53,53,0,53,53,53,0,53,53,53,53,
0,58,0,0,0,58,0,0,0,0,0,
0,0,0,0,0,0,0,0,0,0,0,
0,0,0,0,0,0,0,0,0,0,0,
0,0,0,0,0,0,0,0,0,0,0,
0,0,0,0,0,0,0,0,0,0,0.
