[layer]
type=Tile Layer 1
data=
0,0,0,1,0,0,0,1,0,0,0,
0,0,1,0,1,0,1,0,1,0,0,
25,1,0,0,5,1,6,0,0,1,25,
0,0,0,1,10,10,10,1,0,0,0,
0,0,1,1,1,1,1,1,1,0,0,
0,1,1,21,1,1,1,21,1,1,0,
0,10,21,1,21,1,21,1,21,10,0,
0,10,1,1,1,1,1,1,1,10,0,
0,10,1,21,1,1,1,21,1,10,0,
0,1,1,1,21,21,21,1,1,1,0,
0,0,1,1,1,1,1,1,1,0,0,
0,0,0,1,10,10,10,1,0,0,0,
0,0,0,0,0,0,0,0,0,0,0,
0,0,0,0,0,0,0,0,0,0,0.
[layer]
type=Tile Layer 2
data=
0,0,0,50,0,0,0,50,0,0,0,
0,0,50,0,50,0,50,0,50,0,0,
0,50,0,0,50,50,50,0,0,50,0,
0,0,0,5,5,5,5,5,0,0,0,
0,0,5,40,40,40,40,40,5,0,0,
0,5,40,0,40,40,40,0,40,5,0,
0,30,0,40,0,40,0,40,0,30,0,
0,30,40,40,40,40,40,40,40,30,0,
0,30,40,0,40,40,40,0,40,30,0,
0,5,40,40,0,0,0,40,40,5,0,
0,0,5,40,40,40,40,40,5,0,0,
0,0,0,5,30,30,30,5,0,0,0,
0,0,0,0,0,0,0,0,0,0,0,
0,0,0,0,0,0,0,0,0,0,0.