[layer]
type=Tile Layer 1
data=
0,0,0,1,1,1,1,1,1,0,0,
0,0,1,1,1,1,1,1,1,1,0,
0,1,1,1,1,1,1,1,0,0,21,
0,20,10,10,10,10,10,20,0,0,0,
20,1,1,1,1,1,1,1,20,0,0,
20,1,25,1,1,1,25,1,20,0,0,
20,1,1,1,10,1,1,1,20,0,0,
20,1,1,1,10,1,1,1,20,0,0,
20,20,1,1,1,1,1,20,20,0,0,
0,20,20,21,1,21,20,20,0,0,0,
0,0,20,20,21,20,20,0,0,0,0,
0,0,0,20,1,20,0,0,0,0,0.
[layer]
type=Tile Layer 2
data=
0,0,0,50,50,50,50,50,50,0,0,
0,0,50,50,50,50,50,50,50,200,0,
0,20,20,20,20,20,20,20,0,0,0,
0,0,5,5,5,5,5,0,0,0,0,
0,40,40,40,40,40,40,40,0,0,0,
0,40,0,40,40,40,0,40,0,0,0,
0,40,40,40,10,40,40,40,0,0,0,
0,40,40,40,10,40,40,40,0,0,0,
0,0,40,5,5,5,40,0,0,0,0,
0,0,0,0,5,0,0,0,0,0,0,
0,0,0,0,0,0,0,0,0,0,0,
0,0,0,0,5,0,0,0,0,0,0.