[layer]
type=Tile Layer 1
data=
0,13,0,0,0,0,0,0,13,0,1,
21,1,1,1,25,0,1,1,1,0,1,
0,1,1,1,0,21,1,1,1,0,1,
0,8,1,0,21,0,0,1,7,21,1,
0,20,0,0,0,21,0,0,20,0,1,
21,20,29,0,21,0,0,29,20,0,1,
0,20,1,1,1,21,1,1,20,0,1,
0,20,1,1,21,1,1,1,20,0,1,
0,20,29,0,0,25,0,29,20,0,1,
0,20,20,20,10,10,20,20,20,0,1,
0,0,0,0,0,0,0,0,0,0,0,
0,0,0,0,0,0,0,0,0,0,0,
0,0,0,0,0,0,0,0,0,0,0.
[layer]
type=Tile Layer 2
data=
0,25,0,0,0,0,0,0,25,0,30,
0,36,36,36,0,0,36,36,36,0,30,
0,35,35,35,0,0,35,35,35,0,20,
0,0,60,0,0,0,0,60,0,0,20,
0,0,0,0,0,0,0,0,0,0,20,
0,0,30,0,0,0,0,30,0,0,20,
0,0,29,29,29,0,29,29,0,0,20,
0,0,28,28,0,28,28,28,0,0,20,
0,0,30,0,0,0,0,30,0,0,20,
0,0,0,0,40,40,0,0,0,0,20,
0,0,0,0,0,0,0,0,0,0,0,
0,0,0,0,0,0,0,0,0,0,0,
0,0,0,0,0,0,0,0,0,0,0.
