[layer]
type=Tile Layer 1
data=
0,0,1,1,0,0,0,0,21,21,0,
5,1,1,25,6,0,0,21,0,0,0,
0,1,1,1,0,0,8,0,0,0,0,
0,0,0,0,0,0,17,0,0,0,0,
0,0,0,0,0,0,17,0,0,0,0,
0,0,4,1,1,1,1,1,3,0,0,
0,4,6,25,0,0,0,0,5,3,0,
4,1,0,17,17,0,0,0,0,1,3,
0,1,0,17,17,0,0,16,0,1,0,
0,1,0,0,0,0,0,16,0,1,0,
0,1,1,1,1,1,1,1,1,1,0,
0,0,0,0,0,0,0,0,0,0,0,
0,0,0,0,0,0,0,0,0,0,0,
0,0,0,0,0,0,0,0,0,0,0,
0,0,0,0,0,0,0,0,0,0,0.
[layer]
type=Tile Layer 2
data=
0,0,35,35,0,0,0,0,0,0,0,
35,35,35,0,30,0,0,0,0,0,0,
0,30,30,30,0,0,0,0,0,0,0,
0,0,0,0,0,0,80,0,0,0,0,
0,0,0,0,0,0,80,0,0,0,0,
0,0,40,40,30,30,80,30,30,0,0,
0,40,40,0,0,0,0,0,30,30,0,
10,40,0,30,30,0,0,0,0,30,10,
0,40,0,30,30,0,0,30,0,30,0,
0,40,0,0,0,0,0,30,0,5,0,
0,40,40,40,40,40,80,40,40,40,0,
0,0,0,0,0,0,0,0,0,0,0,
0,0,0,0,0,0,0,0,0,0,0,
0,0,0,0,0,0,0,0,0,0,0,
0,0,0,0,0,0,0,0,0,0,0.
