[layer]
type=Tile Layer 1
data=
25,3,0,0,5,1,3,0,5,3,25,
5,1,3,0,0,5,1,3,0,5,3,
0,5,1,3,0,0,5,1,3,0,5,
3,0,5,1,3,24,0,5,1,3,0,
1,3,0,5,1,3,0,0,5,1,3,
5,1,3,25,5,1,3,0,0,5,1,
0,5,1,3,0,5,1,3,0,0,5,
3,0,5,1,3,0,5,1,3,0,4,
1,3,0,5,1,3,24,5,0,4,1,
5,1,3,0,5,1,3,0,4,1,1,
0,5,1,3,0,5,0,4,1,1,6,
3,25,5,1,3,0,4,1,1,6,21,
1,3,0,5,0,4,1,1,6,21,4,
5,1,3,0,4,1,1,6,21,4,1,
0,5,0,4,1,1,6,21,4,1,1,
7,0,4,1,1,6,21,4,1,1,1,
0,0,0,0,0,0,0,0,0,0,0,
0,0,0,0,0,0,0,0,0,0,0,
0,0,0,0,0,0,0,0,0,0,0,
0,0,0,0,0,0,0,0,0,0,0.
[layer]
type=Tile Layer 2
data=
0,90,0,0,70,100,70,0,80,80,0,
60,90,90,0,0,70,100,70,0,80,80,
0,60,90,90,0,0,70,100,70,0,80,
60,0,60,90,60,0,0,70,100,70,0,
80,60,0,60,90,60,0,0,70,100,70,
60,80,60,0,60,90,60,0,0,70,100,
0,60,80,60,0,60,90,60,0,0,70,
60,0,60,80,60,0,60,90,60,0,60,
80,60,0,60,80,60,0,30,0,60,70,
60,80,60,0,60,80,50,0,60,70,60,
0,60,80,60,0,30,0,60,70,60,50,
60,0,60,80,50,0,60,70,60,50,0,
70,60,0,30,0,60,70,60,50,0,50,
60,70,40,0,60,70,60,50,0,50,60,
0,30,0,60,70,60,50,0,50,60,70,
0,0,60,70,60,50,0,50,60,70,45,
0,0,0,0,0,0,0,0,0,0,0,
0,0,0,0,0,0,0,0,0,0,0,
0,0,0,0,0,0,0,0,0,0,0,
0,0,0,0,0,0,0,0,0,0,0.
