[layer]
type=Tile Layer 1
data=
0,1,1,1,0,0,0,1,1,1,0,
0,1,0,25,1,0,1,25,0,1,0,
0,0,1,1,0,1,0,1,1,0,0,
0,0,0,0,1,1,1,0,0,0,0,
0,0,10,10,10,21,10,10,10,0,0,
0,0,10,1,1,21,1,1,10,0,0,
0,0,10,1,1,21,1,1,10,0,0,
0,0,21,21,21,21,21,21,21,0,0,
0,0,10,1,1,21,1,1,10,0,0,
0,0,10,1,1,21,1,1,10,0,0,
0,0,10,10,10,21,10,10,10,0,0,
0,0,0,0,0,0,0,0,0,0,0,
0,0,0,0,0,0,0,0,0,0,0,
0,0,0,0,0,0,0,0,0,0,0,
0,0,0,0,0,0,0,0,0,0,0.
[layer]
type=Tile Layer 2
data=
0,30,30,30,0,0,0,30,30,30,0,
0,30,0,0,30,0,30,0,0,30,0,
0,0,30,30,0,30,0,30,30,0,0,
0,0,0,50,30,30,30,50,0,0,0,
0,0,30,30,30,0,30,30,30,0,0,
0,0,30,40,40,0,40,40,30,0,0,
0,0,30,40,20,0,20,40,30,0,0,
0,0,0,0,0,0,0,0,0,0,0,
0,0,30,40,20,0,20,40,30,0,0,
0,0,30,40,40,0,40,40,30,0,0,
0,0,30,30,30,0,30,30,30,0,0,
0,0,0,0,0,0,0,0,0,0,0,
0,0,0,0,0,0,0,0,0,0,0,
0,0,0,0,0,0,0,0,0,0,0,
0,0,0,0,0,0,0,0,0,0,0.
