[layer]
type=Tile Layer 1
data=
7,0,0,1,1,1,1,1,0,0,8,
1,1,0,0,0,25,0,0,0,1,1,
1,0,9,1,1,1,1,1,9,0,1,
1,1,1,0,0,0,23,0,1,1,1,
1,1,1,0,22,0,5,0,1,1,1,
1,1,3,0,6,0,0,0,4,1,1,
1,1,0,0,0,0,21,0,0,1,1,
1,1,0,1,1,1,5,1,0,1,1,
1,0,3,1,1,1,1,1,4,0,1,
8,0,10,3,0,1,0,4,10,0,7,
0,0,0,0,0,0,0,0,0,0,0,
0,0,0,0,0,0,0,0,0,0,0,
0,0,0,0,0,0,0,0,0,0,0,
0,0,0,0,0,0,0,0,0,0,0.
[layer]
type=Tile Layer 2
data=
0,0,0,40,40,40,40,40,0,0,0,
20,20,0,0,0,0,0,0,0,20,20,
40,0,30,45,45,45,45,45,30,0,40,
40,5,25,0,0,0,0,0,25,5,40,
40,5,25,0,0,0,25,0,25,5,40,
40,5,25,0,25,0,0,0,25,5,40,
40,5,0,0,0,0,0,0,0,5,40,
40,5,0,5,5,5,25,5,0,5,40,
40,0,10,5,5,5,5,5,10,0,40,
0,0,45,10,0,5,0,10,45,0,0,
0,0,0,0,0,0,0,0,0,0,0,
0,0,0,0,0,0,0,0,0,0,0,
0,0,0,0,0,0,0,0,0,0,0,
0,0,0,0,0,0,0,0,0,0,0.
