[layer]
type=Tile Layer 1
data=
1,1,1,0,0,1,1,0,1,1,0,
0,1,0,0,1,1,1,1,1,1,1,
0,1,0,0,0,1,1,1,1,1,0,
0,1,0,0,0,0,1,1,1,0,0,
1,1,1,0,0,0,0,1,0,0,0,
0,0,0,0,0,0,0,0,0,0,0,
1,0,1,0,1,1,1,0,1,0,1,
1,0,1,0,1,25,1,0,1,0,1,
0,1,0,0,1,25,1,0,1,0,1,
0,1,0,0,1,1,1,0,1,1,1,
8,8,8,0,8,24,8,0,8,8,8.
[layer]
type=Tile Layer 2
data=
70,70,70,0,0,70,70,0,70,70,0,
0,70,0,0,70,70,70,70,70,70,70,
0,70,0,0,0,70,70,70,70,70,0,
0,70,0,0,0,0,70,70,70,0,0,
70,70,70,0,0,0,0,70,0,0,0,
0,0,0,0,0,0,0,0,0,0,0,
20,0,20,0,20,20,20,0,20,0,20,
20,0,20,0,20,0,20,0,20,0,20,
0,20,0,0,20,0,20,0,20,0,20,
0,20,0,0,20,20,20,0,20,20,20,
0,0,0,0,0,0,0,0,0,0,0.