[layer]
type=Tile Layer 1
data=
1,25,1,24,1,1,1,24,1,25,1,
1,1,1,0,1,25,1,0,1,1,1,
0,0,0,0,1,1,1,1,1,1,1,
0,0,0,2,0,0,0,0,25,2,2,
0,0,0,1,21,21,21,4,1,1,1,
0,1,1,1,1,1,1,1,1,1,1,
0,1,1,1,21,21,21,21,1,1,1,
0,0,1,1,1,1,1,1,1,1,1,
0,0,0,1,1,0,0,0,0,1,1,
0,0,0,0,0,0,0,0,0,0,0,
0,0,0,0,0,0,0,0,0,0,0,
0,0,0,0,0,0,0,0,0,0,0,
0,0,0,0,0,0,0,0,0,0,0.
[layer]
type=Tile Layer 2
data=
56,0,56,0,56,56,56,0,56,0,56,
70,70,70,0,70,0,70,0,70,70,70,
0,0,0,0,55,55,55,55,55,55,55,
0,0,0,55,0,0,0,0,0,45,45,
0,0,0,55,0,0,0,45,45,45,45,
0,45,45,40,40,40,40,40,40,40,40,
0,50,50,46,0,0,0,0,46,46,46,
0,0,30,30,30,30,30,30,30,30,30,
0,0,0,42,42,0,0,0,0,42,42,
0,0,0,0,0,0,0,0,0,0,0,
0,0,0,0,0,0,0,0,0,0,0,
0,0,0,0,0,0,0,0,0,0,0,
0,0,0,0,0,0,0,0,0,0,0.
