[layer]
type=Tile Layer 1
data=
1,25,1,1,1,1,1,1,1,1,1,
1,0,0,0,1,21,21,1,1,7,1,
1,1,1,1,1,21,21,1,25,7,1,
1,21,21,21,1,1,1,1,7,1,1,
1,1,21,1,1,0,0,1,1,1,1,
1,1,1,1,1,1,0,1,1,21,1,
1,8,8,8,8,1,25,1,21,21,1,
1,1,1,1,1,1,1,1,1,21,1,
1,1,21,21,1,21,21,21,1,1,1,
1,1,21,21,1,21,1,1,1,1,1,
1,21,1,1,1,1,1,21,1,7,1,
1,21,21,1,8,8,1,21,1,7,1,
1,21,1,8,25,1,21,21,1,7,1,
1,1,21,1,1,21,1,1,1,7,1,
1,21,21,21,1,21,21,21,1,1,1,
1,1,1,1,1,1,1,1,1,1,1,
0,0,0,0,0,0,0,0,0,0,0,
0,0,0,0,0,0,0,0,0,0,0,
0,0,0,0,0,0,0,0,0,0,0,
0,0,0,0,0,0,0,0,0,0,0.
[layer]
type=Tile Layer 2
data=
70,0,70,70,70,70,70,70,70,70,70,
90,0,0,0,90,0,0,90,90,0,90,
60,80,80,80,80,0,0,80,0,0,60,
60,0,0,0,70,70,70,70,0,60,40,
50,55,0,55,55,0,0,55,55,55,35,
35,95,95,95,95,55,0,55,55,0,35,
30,0,0,0,0,30,0,50,0,0,30,
30,80,80,80,60,25,50,30,30,0,30,
30,50,0,0,50,0,0,0,30,50,30,
30,50,0,0,50,0,50,50,50,50,30,
40,0,50,50,50,50,60,0,60,0,70,
40,0,0,40,0,0,40,0,60,0,70,
30,0,40,0,0,30,0,0,60,0,70,
30,40,0,40,30,0,40,50,50,0,60,
20,0,0,0,40,0,0,0,20,20,30,
20,30,30,30,30,40,40,5,30,30,30,
0,0,0,0,0,0,0,0,0,0,0,
0,0,0,0,0,0,0,0,0,0,0,
0,0,0,0,0,0,0,0,0,0,0,
0,0,0,0,0,0,0,0,0,0,0.
