[layer]
type=Tile Layer 1
data=
1,7,0,0,0,0,0,6,0,5,1,
1,0,1,0,1,8,1,0,25,0,1,
1,0,0,6,0,5,0,3,0,4,1,
1,1,6,0,22,0,5,1,1,29,29,
1,6,21,4,1,3,21,5,1,1,1,
6,0,4,29,20,29,3,0,5,20,7,
22,0,20,20,25,20,20,3,29,5,1,
3,0,5,1,20,1,1,20,3,29,20,
1,3,21,5,1,1,1,20,20,20,20,
1,1,3,0,5,1,1,1,1,1,1,
0,0,0,0,0,0,0,0,0,0,0,
0,0,0,0,0,0,0,0,0,0,0,
0,0,0,0,0,0,0,0,0,0,0,
0,0,0,0,0,0,0,0,0,0,0,
0,0,0,0,0,0,0,0,0,0,0.
[layer]
type=Tile Layer 2
data=
20,0,0,0,0,0,0,40,0,40,20,
20,0,30,0,30,0,30,0,0,0,20,
20,0,0,40,0,40,0,40,0,40,20,
30,30,30,0,0,0,30,30,30,20,20,
20,20,0,40,40,40,0,30,30,55,55,
20,0,50,20,0,20,50,0,50,0,0,
0,0,0,0,0,0,0,30,5,60,0,
20,0,20,30,0,30,30,0,60,10,0,
20,20,0,20,20,30,30,0,0,0,0,
20,20,20,0,20,20,20,20,20,20,20,
0,0,0,0,0,0,0,0,0,0,0,
0,0,0,0,0,0,0,0,0,0,0,
0,0,0,0,0,0,0,0,0,0,0,
0,0,0,0,0,0,0,0,0,0,0,
0,0,0,0,0,0,0,0,0,0,0.
