[layer]
type=Tile Layer 1
data=
7,4,1,1,3,0,1,25,1,0,7,
7,5,1,1,6,0,0,0,0,0,7,
0,0,0,0,0,12,12,12,12,12,12,
0,0,0,0,0,0,1,1,1,1,0,
0,0,0,0,0,0,1,1,1,1,0,
0,0,0,0,0,4,1,1,1,1,0,
0,4,23,1,1,23,1,1,1,1,0,
0,1,1,23,1,1,23,1,1,1,0,
0,1,1,1,23,1,1,23,1,1,0,
0,5,1,1,1,23,1,1,23,6,0,
0,0,0,0,0,0,0,0,0,0,0,
0,0,0,0,0,0,0,0,0,0,0,
0,0,0,0,0,0,0,0,0,0,0.
[layer]
type=Tile Layer 2
data=
0,40,80,80,40,0,60,0,60,0,0,
0,40,80,80,40,0,0,0,0,0,0,
0,0,0,0,0,20,20,20,20,20,20,
0,0,0,0,0,0,20,50,50,5,0,
0,0,0,0,0,0,20,50,50,5,0,
0,0,0,0,0,20,50,50,50,5,0,
0,20,0,20,20,0,50,50,50,5,0,
0,20,50,0,50,50,0,50,50,5,0,
0,20,50,50,0,50,50,0,50,5,0,
0,20,20,20,20,0,20,20,0,20,0,
0,0,0,0,0,0,0,0,0,0,0,
0,0,0,0,0,0,0,0,0,0,0,
0,0,0,0,0,0,0,0,0,0,0.
