[layer]
type=Tile Layer 1
data=
0,4,0,1,0,1,0,1,0,3,0,
0,1,21,1,21,1,25,1,21,1,0,
1,1,1,1,1,1,1,1,1,1,1,
0,1,1,1,1,1,1,1,1,1,0,
1,1,1,1,1,24,1,1,1,1,1,
0,0,0,25,0,0,0,0,0,0,1,
0,17,0,17,0,17,0,0,0,1,1,
0,1,1,1,1,1,0,0,1,1,21,
0,1,1,1,1,1,0,1,1,21,0,
1,1,1,24,1,1,1,1,21,0,0,
0,0,21,1,0,0,0,0,0,0,0,
0,21,1,0,0,0,0,25,0,0,0,
21,1,0,0,0,16,21,16,21,16,0,
1,21,0,0,0,1,1,1,1,1,0,
0,1,21,0,0,1,1,24,1,1,0,
0,0,1,1,1,1,1,1,1,1,1,
0,0,0,0,0,0,0,0,0,0,0,
0,0,0,0,0,0,0,0,0,0,0,
0,0,0,0,0,0,0,0,0,0,0,
0,0,0,0,0,0,0,0,0,0,0.
[layer]
type=Tile Layer 2
data=
0,40,0,50,0,70,0,50,0,40,0,
0,80,0,80,0,80,0,80,0,80,0,
50,60,80,70,70,30,70,70,80,60,50,
0,40,60,70,40,70,40,70,60,40,0,
30,60,60,60,60,0,60,60,60,60,30,
0,0,0,0,0,0,0,0,0,0,50,
0,50,0,70,0,50,0,0,0,50,50,
0,50,80,80,80,50,0,0,50,50,0,
0,50,80,80,80,50,0,50,50,0,0,
50,70,70,70,70,70,50,50,0,0,0,
0,0,0,30,0,0,0,0,0,0,0,
0,0,30,0,0,0,0,0,0,0,0,
0,30,0,0,0,50,0,60,0,50,0,
30,0,0,0,0,50,60,80,60,50,0,
0,30,0,0,0,50,60,60,60,50,0,
0,0,30,30,40,50,50,5,50,50,30,
0,0,0,0,0,0,0,0,0,0,0,
0,0,0,0,0,0,0,0,0,0,0,
0,0,0,0,0,0,0,0,0,0,0,
0,0,0,0,0,0,0,0,0,0,0.
