[layer]
type=Tile Layer 1
data=
0,3,1,1,1,0,5,1,1,1,21,
0,1,1,1,3,25,1,1,4,1,21,
0,25,3,1,0,0,0,1,1,21,0,
0,6,1,1,3,7,4,1,5,1,21,
0,1,1,4,1,24,1,1,1,5,21,
4,3,1,1,21,0,0,1,4,1,3,
1,5,1,25,0,0,0,21,1,5,1,
1,4,5,25,0,0,21,0,1,1,1,
1,1,1,3,21,0,0,1,1,4,1,
5,1,4,1,1,21,6,1,3,1,6,
21,6,1,1,6,7,5,6,1,1,25,
0,0,1,1,21,0,0,1,4,0,0,
21,3,1,1,3,0,4,6,1,1,0,
21,1,1,1,4,0,1,1,1,5,0,
21,1,4,1,1,0,1,1,4,1,0,
0,0,0,21,0,0,0,0,0,0,0,
0,0,0,0,0,0,0,0,0,0,0,
0,0,0,0,0,0,0,0,0,0,0,
0,0,0,0,0,0,0,0,0,0,0.
[layer]
type=Tile Layer 2
data=
0,73,73,73,73,0,73,73,73,73,0,
0,72,72,72,72,0,72,72,72,72,0,
0,0,73,73,0,0,0,73,73,0,0,
0,96,96,96,96,0,96,96,96,96,0,
0,94,94,94,94,0,94,94,94,94,0,
57,57,57,57,0,0,0,57,57,57,57,
63,63,63,0,0,0,0,0,63,63,63,
62,62,62,0,0,0,0,0,62,62,62,
49,49,49,49,0,0,0,49,49,49,49,
38,38,38,38,38,0,38,38,38,38,38,
0,72,72,72,72,0,72,72,72,72,0,
0,0,52,52,0,0,0,52,52,0,0,
0,46,46,46,46,0,46,46,46,46,0,
0,45,45,45,45,0,45,45,45,45,0,
0,44,44,44,44,0,44,44,44,44,0,
0,0,0,0,0,0,0,0,0,0,0,
0,0,0,0,0,0,0,0,0,0,0,
0,0,0,0,0,0,0,0,0,0,0,
0,0,0,0,0,0,0,0,0,0,0.
