[layer]
type=Tile Layer 1
data=
1,1,1,1,1,24,1,1,1,1,1,
1,0,1,1,1,1,1,1,1,0,1,
24,1,1,1,1,25,1,1,1,1,24,
0,1,1,1,6,24,5,1,1,1,0,
0,4,3,24,4,0,3,24,4,3,0,
3,5,6,4,6,0,5,3,5,6,4,
1,3,4,1,3,0,4,1,3,4,1,
12,12,12,12,12,24,12,12,12,12,12,
1,0,1,0,1,12,1,0,1,0,1,
1,1,0,1,0,0,0,1,0,1,1,
1,1,1,1,1,24,1,1,1,1,1,
0,0,0,0,0,0,0,0,0,0,0,
0,0,0,0,0,0,0,0,0,0,0,
0,0,0,0,0,0,0,0,0,0,0.
[layer]
type=Tile Layer 2
data=
50,50,50,50,50,0,50,50,50,50,50,
50,0,50,50,50,20,50,50,50,0,50,
0,50,50,50,50,0,50,50,50,50,0,
0,100,100,100,100,0,100,100,100,100,0,
0,50,50,0,50,0,50,0,50,50,0,
50,50,50,50,50,0,50,50,50,50,50,
50,50,50,50,50,0,50,50,50,50,50,
2,2,2,2,2,0,2,2,2,2,2,
5,0,5,0,10,2,10,0,5,0,5,
5,5,0,10,0,0,0,10,0,5,5,
5,5,5,10,10,0,10,10,5,5,5,
0,0,0,0,0,0,0,0,0,0,0,
0,0,0,0,0,0,0,0,0,0,0,
0,0,0,0,0,0,0,0,0,0,0.
