[layer]
type=Tile Layer 1
data=
1,1,1,1,1,1,1,1,1,1,0,
1,25,0,0,0,0,0,0,0,0,0,
1,0,1,1,1,1,1,1,1,1,0,
1,0,1,25,0,0,0,0,0,0,0,
1,0,1,0,1,1,1,1,1,1,21,
1,0,1,0,1,25,0,0,0,0,21,
1,0,1,0,1,0,1,1,1,1,21,
1,0,1,0,1,0,1,0,0,0,21,
1,0,1,0,1,0,1,0,1,1,21,
1,0,1,0,1,0,1,0,1,21,21,
12,13,12,13,12,13,12,13,12,21,21,
0,0,0,0,0,0,0,0,0,0,0,
0,0,0,0,0,0,0,0,0,0,0,
0,0,0,0,0,0,0,0,0,0,0,
0,0,0,0,0,0,0,0,0,0,0.
[layer]
type=Tile Layer 2
data=
30,30,30,30,30,30,30,30,30,30,0,
30,0,0,0,0,0,0,0,0,0,0,
30,0,40,40,40,40,40,40,40,40,0,
30,0,40,0,0,0,0,0,0,0,0,
100,0,100,0,100,100,100,100,100,100,0,
100,0,100,0,100,0,0,0,0,0,0,
100,0,100,0,100,0,100,100,100,100,0,
100,0,100,0,100,0,100,0,0,0,0,
100,0,100,0,100,0,100,0,100,100,0,
100,0,100,0,100,0,100,0,100,0,0,
10,10,10,10,10,10,10,10,10,0,0,
0,0,0,0,0,0,0,0,0,0,0,
0,0,0,0,0,0,0,0,0,0,0,
0,0,0,0,0,0,0,0,0,0,0,
0,0,0,0,0,0,0,0,0,0,0.
