[layer]
type=Tile Layer 1
data=
0,0,8,0,0,0,0,0,8,0,0,
1,0,1,0,1,1,1,0,1,1,1,
1,0,1,0,1,25,1,0,1,25,1,
1,1,1,0,1,1,1,0,1,1,1,
1,0,1,0,1,0,1,0,1,0,0,
1,0,1,0,1,0,1,0,1,0,0,
0,0,0,21,21,21,21,21,0,0,0,
0,1,1,1,0,1,0,1,0,1,0,
0,1,25,1,0,1,0,1,0,1,0,
0,1,1,1,0,1,0,1,0,1,0,
0,1,0,0,0,0,1,0,0,0,0,
0,1,0,0,0,0,1,0,0,1,0,
0,0,0,0,0,0,0,0,0,0,0,
0,4,3,4,3,4,3,4,3,7,0,
0,5,6,5,6,5,6,5,6,8,0,
0,0,0,0,0,0,0,0,0,0,0,
0,0,0,0,0,0,0,0,0,0,0.
[layer]
type=Tile Layer 2
data=
0,0,0,0,0,0,0,0,0,0,0,
80,0,80,0,80,80,80,0,80,80,80,
80,0,80,0,80,0,80,0,80,0,80,
80,80,80,0,80,80,80,0,80,80,80,
80,0,80,0,80,0,80,0,80,0,0,
80,0,80,0,80,0,80,0,80,0,0,
0,0,0,0,0,0,0,0,0,0,0,
0,40,40,40,0,40,0,40,0,40,0,
0,40,0,40,0,40,0,40,0,40,0,
0,40,40,40,0,40,0,40,0,40,0,
0,40,0,0,0,0,40,0,0,0,0,
0,40,0,0,0,0,40,0,0,40,0,
0,0,0,0,0,0,0,0,0,0,0,
0,1,1,1,1,1,1,1,1,0,0,
0,1,1,1,1,1,1,1,1,0,0,
0,0,0,0,0,0,0,0,0,0,0,
0,0,0,0,0,0,0,0,0,0,0.
