[layer]
type=Tile Layer 1
data=
0,0,21,21,21,25,21,21,21,0,0,
5,1,1,1,1,1,1,1,1,1,6,
0,1,1,1,1,1,1,1,1,1,0,
0,0,1,25,21,24,21,21,1,0,0,
0,1,1,1,1,1,1,1,1,1,0,
0,0,1,0,0,0,0,0,1,0,0,
0,0,1,0,0,0,0,0,1,0,0,
0,0,1,0,0,0,0,0,1,0,0,
0,4,1,3,0,0,0,4,1,3,0,
0,0,0,0,0,0,0,0,0,0,0,
0,0,0,0,0,0,0,0,0,0,0,
0,0,0,0,0,0,0,0,0,0,0,
0,0,0,0,0,0,0,0,0,0,0.
[layer]
type=Tile Layer 2
data=
0,0,0,0,0,0,0,0,0,0,0,
15,80,80,80,80,80,80,80,80,80,15,
0,50,50,50,50,50,50,50,50,50,0,
0,0,70,0,0,0,0,0,70,0,0,
0,30,60,60,60,3,60,60,60,30,0,
0,0,50,0,0,0,0,0,50,0,0,
0,0,50,0,0,0,0,0,50,0,0,
0,0,50,0,0,0,0,0,50,0,0,
0,45,60,45,0,0,0,45,60,45,0,
0,0,0,0,0,0,0,0,0,0,0,
0,0,0,0,0,0,0,0,0,0,0,
0,0,0,0,0,0,0,0,0,0,0,
0,0,0,0,0,0,0,0,0,0,0.
