[layer]
type=Tile Layer 1
data=
0,0,0,0,1,25,1,0,0,0,0,
0,0,0,1,0,0,0,1,0,0,0,
0,0,0,0,1,0,1,0,0,0,0,
0,0,0,0,0,24,0,0,0,0,0,
0,0,0,0,10,0,10,0,0,0,0,
0,0,0,10,1,1,1,10,0,0,0,
0,0,0,10,1,1,1,10,0,0,0,
0,0,0,10,1,1,1,10,0,0,0,
0,0,10,1,1,1,1,1,10,0,0,
0,0,10,1,1,1,1,1,10,0,0,
0,10,10,10,10,0,10,10,10,10,0,
0,0,0,0,4,24,3,0,0,0,0,
0,0,0,0,0,0,0,0,0,0,0,
0,0,0,0,0,0,0,0,0,0,0,
0,0,0,0,0,0,0,0,0,0,0.
[layer]
type=Tile Layer 2
data=
0,0,0,0,50,0,50,0,0,0,0,
0,0,0,50,0,0,0,50,0,0,0,
0,0,0,0,50,0,50,0,0,0,0,
0,0,0,0,0,0,0,0,0,0,0,
0,0,0,0,50,5,50,0,0,0,0,
0,0,0,50,25,25,25,50,0,0,0,
0,0,0,50,25,25,25,50,0,0,0,
0,0,0,50,25,25,25,50,0,0,0,
0,0,50,25,25,25,25,25,50,0,0,
0,0,50,25,25,5,25,25,50,0,0,
0,50,50,50,50,5,50,50,50,50,0,
0,0,0,0,5,5,5,0,0,0,0,
0,0,0,0,0,0,0,0,0,0,0,
0,0,0,0,0,0,0,0,0,0,0,
0,0,0,0,0,0,0,0,0,0,0.