[layer]
type=Tile Layer 1
data=
10,10,10,10,10,10,10,10,10,10,10,
10,0,0,0,0,0,0,0,0,0,10,
10,0,10,1,1,1,1,1,1,0,10,
10,0,10,0,0,0,0,0,1,0,10,
10,0,10,0,1,1,25,0,1,0,10,
10,0,10,0,1,0,0,0,1,0,10,
10,0,10,0,1,1,1,1,1,0,10,
10,0,10,0,0,0,0,0,0,0,10,
10,0,10,10,10,10,10,10,10,10,10,
0,0,0,0,0,0,0,0,0,0,0,
0,0,0,0,0,0,0,0,0,0,0.
[layer]
type=Tile Layer 2
data=
40,40,40,40,40,40,40,40,40,40,40,
40,0,0,0,0,0,0,0,0,0,40,
40,0,40,40,40,40,40,40,40,0,40,
40,0,40,0,0,0,0,0,40,0,40,
40,0,40,0,40,40,0,0,40,0,40,
40,0,40,0,40,0,0,0,40,0,40,
40,0,40,0,40,40,40,40,40,0,40,
40,0,40,0,0,0,0,0,0,0,40,
40,0,40,40,40,40,40,40,40,40,40,
0,0,0,0,0,0,0,0,0,0,0,
0,0,0,0,0,0,0,0,0,0,0.
