[layer]
type=Tile Layer 1
data=
0,25,1,1,1,1,1,1,1,25,0,
0,0,5,1,1,1,1,1,6,0,0,
0,0,0,5,1,8,1,6,0,0,0,
0,0,0,0,4,1,3,0,0,0,0,
0,4,3,0,1,1,1,0,4,3,0,
0,1,2,0,1,1,1,0,2,1,0,
0,1,29,0,9,1,9,0,29,1,0,
0,1,2,0,1,1,1,0,2,1,0,
0,1,29,1,1,1,1,1,29,1,0,
0,1,2,1,1,25,1,1,2,1,0,
5,1,29,1,1,1,1,1,29,1,6,
0,0,0,0,10,10,10,0,0,0,0,
0,0,0,0,0,0,0,0,0,0,0,
0,0,0,0,0,0,0,0,0,0,0.
[layer]
type=Tile Layer 2
data=
0,0,60,60,60,60,60,60,60,0,0,
0,0,60,60,60,60,60,60,60,0,0,
0,0,0,60,60,0,60,60,0,0,0,
0,0,0,0,60,60,60,0,0,0,0,
0,60,60,0,60,60,60,0,60,60,0,
0,100,100,0,60,60,60,0,100,100,0,
0,100,5,0,5,60,5,0,5,100,0,
0,100,100,0,60,60,60,0,100,100,0,
0,100,5,100,60,60,60,100,5,100,0,
0,100,100,100,60,0,60,100,100,100,0,
100,100,5,100,60,60,60,100,5,100,100,
0,0,0,0,40,40,40,0,0,0,0,
0,0,0,0,0,0,0,0,0,0,0,
0,0,0,0,0,0,0,0,0,0,0.
