[layer]
type=Tile Layer 1
data=
0,0,1,0,1,25,1,0,1,0,0,
0,1,0,1,0,1,0,1,0,1,0,
1,0,1,0,1,0,1,0,1,0,1,
0,1,7,1,0,1,0,1,0,1,0,
1,0,1,0,1,25,1,0,1,0,1,
0,1,0,1,0,1,0,1,7,1,0,
1,0,1,0,1,0,1,0,1,0,1,
0,1,0,1,0,1,0,1,0,1,0,
0,0,0,0,1,0,1,0,0,0,0,
0,4,3,0,0,25,0,0,4,3,0,
4,3,4,3,0,0,0,4,3,4,3,
1,1,1,1,0,0,0,1,1,1,1,
21,1,1,0,0,0,0,0,1,1,21,
21,1,1,0,0,0,0,0,1,1,21,
0,1,1,12,12,12,12,12,1,1,0,
0,1,1,0,0,0,0,0,1,1,0,
0,1,1,0,0,0,0,0,1,1,0,
0,0,0,0,0,0,0,0,0,0,0,
0,0,0,0,0,0,0,0,0,0,0,
0,0,0,0,0,0,0,0,0,0,0.
[layer]
type=Tile Layer 2
data=
0,0,60,0,80,0,60,0,80,0,0,
0,80,0,60,0,80,0,60,0,80,0,
90,0,50,0,90,0,50,0,90,0,50,
0,70,0,90,0,90,0,80,0,70,0,
60,0,40,0,70,0,70,0,40,0,60,
0,60,0,95,0,95,0,95,0,60,0,
40,0,50,0,50,0,50,0,50,0,40,
0,30,0,50,0,70,0,50,0,30,0,
0,0,0,0,40,0,40,0,0,0,0,
0,65,65,0,0,0,0,0,65,65,0,
60,60,60,60,0,0,0,60,60,60,60,
50,80,80,50,0,0,0,50,80,80,50,
0,80,80,0,0,0,0,0,80,80,0,
0,80,80,0,0,0,0,0,80,80,0,
0,80,80,20,40,60,40,20,80,80,0,
0,80,80,0,0,0,0,0,80,80,0,
0,30,30,0,0,0,0,0,30,30,0,
0,0,0,0,0,0,0,0,0,0,0,
0,0,0,0,0,0,0,0,0,0,0,
0,0,0,0,0,0,0,0,0,0,0.
