[layer]
type=Tile Layer 1
data=
0,0,0,0,0,0,0,0,0,0,0,
25,4,3,4,3,4,3,4,3,24,0,
0,25,21,21,21,21,21,21,21,21,25,
0,0,0,0,0,0,0,0,0,0,0,
0,0,0,0,0,0,0,0,0,0,0,
0,0,0,0,0,4,3,0,0,0,0,
0,0,0,0,4,1,1,3,4,3,0,
0,4,3,4,1,1,1,1,1,1,3,
1,24,1,1,1,1,1,1,1,1,1,
1,7,1,1,1,1,1,1,1,1,1,
0,0,0,0,0,0,0,0,0,0,0,
0,0,0,0,0,0,0,0,0,0,0,
0,0,0,0,0,0,0,0,0,0,0,
0,0,0,0,0,0,0,0,0,0,0.
[layer]
type=Tile Layer 2
data=
0,0,0,0,0,0,0,0,0,0,0,
0,50,50,50,50,50,50,50,50,0,0,
0,0,0,0,0,0,0,0,0,0,0,
0,0,0,0,0,0,0,0,0,0,0,
0,0,0,0,0,0,0,0,0,0,0,
0,0,0,0,0,5,5,0,0,0,0,
0,0,0,0,55,55,55,55,5,5,0,
0,5,5,60,60,60,60,60,60,60,60,
50,0,65,65,65,65,65,65,65,65,65,
50,0,50,50,50,50,50,50,50,50,50,
0,0,0,0,0,0,0,0,0,0,0,
0,0,0,0,0,0,0,0,0,0,0,
0,0,0,0,0,0,0,0,0,0,0,
0,0,0,0,0,0,0,0,0,0,0.
