[layer]
type=Tile Layer 1
data=
0,0,0,25,0,25,0,25,0,0,0,
0,0,4,3,4,3,4,3,0,0,0,
0,0,4,3,4,3,4,3,0,0,0,
7,4,3,4,3,4,3,4,3,0,0,
7,4,3,4,3,4,3,4,3,0,0,
4,3,4,3,7,25,4,3,4,3,0,
4,3,4,3,4,3,4,3,4,3,0,
4,3,4,3,4,3,4,3,4,3,0,
21,21,0,0,21,21,0,0,21,21,0,
0,4,3,0,4,3,0,0,4,3,0,
0,4,3,0,4,3,0,0,4,3,0,
0,4,3,0,4,3,0,0,4,3,0,
0,4,3,0,4,3,0,0,4,3,0,
0,4,3,0,4,3,0,0,4,3,0,
0,4,3,0,4,3,0,0,4,3,0,
0,21,21,0,21,21,0,0,21,21,0,
0,0,0,0,0,0,0,0,0,0,0,
0,0,0,0,0,0,0,0,0,0,0,
0,0,0,0,0,0,0,0,0,0,0,
0,0,0,0,0,0,0,0,0,0,0.
[layer]
type=Tile Layer 2
data=
0,0,0,0,0,0,0,0,0,0,0,
0,0,60,90,60,60,90,60,0,0,0,
0,0,60,60,30,30,60,60,0,0,0,
0,80,80,60,60,80,80,60,60,0,0,
0,80,80,60,60,80,80,60,60,0,0,
70,70,90,90,0,0,90,90,70,70,0,
70,70,90,90,100,100,90,90,70,70,0,
70,70,90,90,100,100,90,90,70,70,0,
0,0,0,0,0,0,0,0,0,0,0,
0,80,80,0,80,80,0,0,90,90,0,
0,80,80,0,80,80,0,0,90,90,0,
0,80,80,0,80,80,0,0,90,90,0,
0,80,80,0,80,80,0,0,90,90,0,
0,55,65,0,70,70,0,0,65,55,0,
0,50,30,0,50,50,0,0,30,50,0,
0,0,0,0,0,0,0,0,0,0,0,
0,0,0,0,0,0,0,0,0,0,0,
0,0,0,0,0,0,0,0,0,0,0,
0,0,0,0,0,0,0,0,0,0,0,
0,0,0,0,0,0,0,0,0,0,0.
